501st_clonetrooper.alo	Mod	['Units_land_Empire_501st_Stormtrooper.xml']
age_of_strife.alo	Mod	['Units_Space_Neutral_Age_of_Strife.xml']
allegiance_star_destroyer.alo	Mod	['Units_Space_Empire_Allegiance.xml']
arbitrator.alo	Mod	['Units_hero_empire_Arbitrator.xml']
ar_nv_golani.alo	Unused?	[]
ar_nv_golanii.alo	Unused?	[]
ar_nv_golaniii.alo	Unused?	[]
assaultfrigate2.alo	Unused?	[]
assaultfrigate_death.alo	Unused?	[]
assault_frigate.alo	Unused?	[]
assertor_super_star_destroyer.alo	Unused?	[]
a_laserexplo_hull_green_large.alo	Mod	['Particles.xml']
a_laserexplo_hull_red_large.alo	Mod	['Particles.xml']
a_laserexplo_space_green_large.alo	Mod	['Particles.xml']
a_laserexplo_space_red_large.alo	Mod	['Particles.xml']
a_shield_blast_medium_green.alo	Mod	['Particles.xml']
a_shield_blast_medium_red.alo	Mod	['Particles.xml']
bellator_super_star_destroyer.alo	Unused?	[]
bloodstar.alo	Unused?	[]
bloodstar_d.alo	Unused?	[]
bloodstar_turret_01.alo	Unused?	[]
bloodstar_turret_02.alo	Unused?	[]
bloodstar_turret_03.alo	Unused?	[]
bloodstar_turret_04.alo	Unused?	[]
blue_diver.alo	Mod	['Units_space_rebel_MonCalHC.xml']
blue_diver_d.alo	Unused?	[]
cis_aat.alo	Mod	['Units_land_cis_aat_tank.xml']
cis_aat_cw.alo	Mod	['Units_land_cis_aat_tank.xml']
cis_aa_turret.alo	Mod	['GroundbuildablesCIS.xml', 'groundturrets_cis.xml']
cis_b1_assault.alo	Mod	['Units_land_cis_plex_droid.xml']
cis_b1_battledroid.alo	Mod	['Units_land_cis_battledroid.xml']
cis_b1_commander_oom.alo	Mod	['Units_land_cis_B1_droid_commander.xml']
cis_b1_commander_oom_geo.alo	Mod	['Units_land_cis_B1_droid_commander.xml']
cis_b1_heavy.alo	Mod	['Units_land_cis_battledroid_heavy.xml']
cis_b1_heavy_geo.alo	Unused?	[]
cis_b1_specialist.alo	Mod	['Units_land_cis_battledroid_specialist.xml']
cis_b1_specialist_geo.alo	Unused?	[]
cis_b2droid.alo	Mod	['Units_land_cis_super_battledroid.xml']
cis_bx_commando.alo	Mod	['Units_land_cis_bx_commando.xml']
cis_bx_commando_captain.alo	Mod	['Units_land_cis_bx_commando.xml']
cis_droideka.alo	Mod	['Units_land_cis_destroyerdroids.xml']
cis_hailfire.alo	Mod	['Units_land_cis_hailfire_tank.xml']
cis_hailfire_urban.alo	Mod	['Units_land_cis_hailfire_tank.xml']
cis_infantry_turret.alo	Mod	['GroundbuildablesCIS.xml', 'groundturrets_cis.xml']
cis_magnaguard.alo	Mod	['Units_land_cis_magnaguards.xml']
cis_octuptarra.alo	Mod	['Units_land_cis_Octuparra.xml']
cis_poggle.alo	Unused?	[]
cis_snail_tank.alo	Mod	['Units_land_cis_enforcer_tank.xml']
cis_station_level1.alo	Unused?	[]
cis_station_level1_d.alo	Unused?	[]
cis_station_level2.alo	Unused?	[]
cis_station_level2_d.alo	Unused?	[]
cis_station_level3.alo	Unused?	[]
cis_station_level3_d.alo	Unused?	[]
cis_station_level4.alo	Unused?	[]
cis_station_level4_d.alo	Unused?	[]
cis_station_level5.alo	Unused?	[]
cis_station_level5_d.alo	Unused?	[]
cis_tri_fighter.alo	Mod	['Units_space_cis_tridroid.xml']
cis_vehicle_turret.alo	Mod	['GroundbuildablesCIS.xml', 'groundturrets_cis.xml']
cis_vulture_droid.alo	Mod	['Units_space_cis_vulture.xml']
cis_v_munificent.alo	Unused?	[]
cv_bulwark_mk1.alo	Mod	['Units_space_Confederacy_bulwark.xml']
dark_mercy_star_defender.alo	Unused?	[]
darth_maul.alo	Unused?	[]
death_lives.alo	Mod	['Units_Space_Neutral_Death_lives.xml']
dominator_i-class_star_destroyer.alo	Mod	['Units_Space_Empire_Star_Destroyer_Dominator.xml']
dreadnought.alo	Unused?	[]
dreadnoughtiv.alo	Unused?	[]
dreadnought_d.alo	Unused?	[]
ei_armytrooper.alo	Mod	['Units_land_empire_armytrooper.xml']
ei_armytrooperarmored.alo	Unused?	[]
ei_armytrooperarmoredlieutenant.alo	Unused?	[]
ei_armytrooper_engineer.alo	Unused?	[]
ei_armytrooper_medic.alo	Unused?	[]
ei_armytrooper_officer.alo	Unused?	[]
ei_biker.alo	Mod	['Units_land_empire_Scout_Trooper.xml']
ei_bobafett.alo	Mod	['Units_hero_Hutt_Cartel_Boba_Fett.xml']
ei_clone_purge_trooper.alo	Mod	['Units_land_empire_purge_trooper.xml']
ei_darktrooper.alo	Mod	['Units_land_empire_DarkTrooperSoldier.xml']
ei_darktrooperatat.alo	Mod	['Units_land_empire_DarkTrooperSoldier.xml']
ei_deathtrooper.alo	Mod	['Units_land_Empire_Deathtroopers.xml']
ei_deathtrooper_leader.alo	Unused?	[]
ei_deathtrooper_v2.alo	Unused?	[]
ei_del.alo	Mod	['Units_hero_empire_inferno_squad.xml']
ei_gunner.alo	Mod	['Units_land_Empire_Imperial_Engineer.xml']
ei_hask.alo	Mod	['Units_hero_empire_inferno_squad.xml']
ei_hero_admiral_pellaeon_officer.alo	Unused?	[]
ei_iden.alo	Mod	['Units_hero_empire_inferno_squad.xml']
ei_imperial_clonetrooper.alo	Mod	['Units_land_empire_Imperial_Clonetrooper.xml']
ei_imperial_super_commando.alo	Mod	['Units_land_empire_super_commands.xml']
ei_magmatrooper.alo	Mod	['Units_land_Empire_Magmatroopers.xml']
ei_mudtrooper.alo	Mod	['Units_land_Empire_Mimban_stormtroopers.xml']
ei_mustafartrooper.alo	Mod	['Units_land_empire_Mustafar_Trooper.xml']
ei_novatrooper.alo	Mod	['Units_land_empire_Novatroopers.xml']
ei_shadow_trooper.alo	Mod	['Units_land_empire_Shadowtrooper.xml']
ei_shocktrooper.alo	Mod	['Units_land_Empire_Shocktroopers.xml']
ei_shocktrooper_heavy.alo	Mod	['Units_land_Empire_flametroopers.xml']
ei_shocktrooper_snow.alo	Unused?	[]
ei_shoretrooper.alo	Mod	['Units_land_Empire_Shoretroopers.xml']
ei_shoretrooper_captain.alo	Unused?	[]
ei_thrawn.alo	Mod	['Units_hero_empire_thrawn.xml']
ei_trooper.alo	Mod	['Units_land_empire_Imperial_Stormtrooper.xml', 'units_land_empire_stormtrooper.xml', 'units_land_empire_stormtrooper.xml', 'units_land_empire_stormtrooper.xml', 'units_land_empire_stormtrooper.xml', 'units_land_empire_stormtrooper.xml', 'units_land_empire_stormtrooper.xml', 'units_land_empire_stormtrooper.xml', 'units_land_empire_stormtrooper.xml', 'units_land_empire_stormtrooper.xml', 'units_land_empire_stormtrooper.xml', 'units_land_empire_stormtrooper.xml']
ei_trooper_flame.alo	Unused?	[]
ei_trooper_heavy_z6.alo	Unused?	[]
ei_trooper_officer.alo	Mod	['Genericherounits.xml']
ei_trooper_ph1.alo	Unused?	[]
ei_trooper_sand.alo	Mod	['Units_land_Empire_Sandtroopers.xml']
ei_trooper_snow.alo	Mod	['Units_land_Empire_Snowtroopers.xml']
ei_vader.alo	Mod	['Units_hero_empire_Darth_Vader.xml']
empire_dominator_star_destroyer.alo	Unused?	[]
empire_immobilizer_418.alo	Unused?	[]
empire_shieldgate_lvl1.alo	Unused?	[]
empire_shieldgate_lvl1_gc.alo	Mod	['Starbases.xml']
empire_shieldgate_lvl2.alo	Unused?	[]
empire_shieldgate_lvl2_gc.alo	Mod	['Starbases.xml']
empire_shieldgate_lvl3.alo	Unused?	[]
empire_shieldgate_lvl3_gc.alo	Mod	['Starbases.xml']
empire_shieldgate_lvl4.alo	Unused?	[]
empire_shieldgate_lvl4_gc.alo	Mod	['Starbases.xml']
empire_shieldgate_lvl5.alo	Unused?	[]
empire_shieldgate_lvl5_gc.alo	Mod	['Starbases.xml']
empire_shieldgate_turret_01.alo	Mod	['Hardpoints.xml']
empire_shieldgate_turret_02.alo	Mod	['Hardpoints.xml']
empire_shieldgate_turret_03.alo	Mod	['Hardpoints.xml']
empire_shieldgate_turret_04.alo	Mod	['Hardpoints.xml']
empire_shieldgate_turret_05.alo	Mod	['Hardpoints.xml']
empire_shieldgate_turret_06.alo	Mod	['Hardpoints.xml']
empire_shieldgate_turret_07.alo	Mod	['Hardpoints.xml']
empire_shieldgate_turret_08.alo	Mod	['Hardpoints.xml']
empire_shieldgate_turret_09.alo	Mod	['Hardpoints.xml']
empire_shieldgate_turret_10.alo	Mod	['Hardpoints.xml']
empire_shieldgate_turret_11.alo	Mod	['Hardpoints.xml']
empire_shieldgate_turret_12.alo	Mod	['Hardpoints.xml']
empire_shieldgate_turret_13.alo	Mod	['Hardpoints.xml']
empire_shieldgate_turret_14.alo	Mod	['Hardpoints.xml']
empire_shieldgate_turret_15.alo	Mod	['Hardpoints.xml']
empire_shieldgate_turret_16.alo	Mod	['Hardpoints.xml']
empire_shieldgate_turret_17.alo	Mod	['Hardpoints.xml']
empire_shieldgate_turret_18.alo	Mod	['Hardpoints.xml']
empire_shieldgate_turret_19.alo	Mod	['Hardpoints.xml']
empire_shieldgate_turret_20.alo	Mod	['Hardpoints.xml']
empire_shieldgate_turret_21.alo	Mod	['Hardpoints.xml']
empire_shieldgate_turret_22.alo	Mod	['Hardpoints.xml']
empire_shieldgate_turret_23.alo	Mod	['Hardpoints.xml']
empire_shieldgate_turret_24.alo	Mod	['Hardpoints.xml']
empire_starbase_level_01.alo	Mod	['Starbases.xml']
empire_starbase_level_02.alo	Mod	['Starbases.xml']
empire_starbase_level_03.alo	Mod	['Starbases.xml']
empire_starbase_level_04.alo	Mod	['Starbases.xml']
empire_starbase_level_05.alo	Mod	['Starbases.xml']
empire_tie_advanced.alo	Mod	['Units_Space_Empire_TIE_Prototype.xml']
empire_tie_inquisitor.alo	Mod	['Units_Space_Empire_TIE_Inquisitor.xml']
empire_tie_interceptor_royal.alo	Mod	['Units_space_empire_TIE_Interceptor_Royal.xml']
empire_tie_phantom.alo	Mod	['Units_space_empire_tie_phantom.xml']
empire_tie_striker.alo	Mod	['Units_Land_Empire_Striker.xml']
empire_vindicator.alo	Unused?	[]
empire_xyston_sd_cannon.alo	Unused?	[]
evfo_atat.alo	Unused?	[]
evfo_dreadnought_gunl.alo	Unused?	[]
evfo_dreadnought_gunr.alo	Unused?	[]
evfo_onager.alo	Unused?	[]
evfo_onager_d.alo	Unused?	[]
evfo_onager_turret_01.alo	Unused?	[]
evfo_onager_turret_02.alo	Unused?	[]
evfo_onager_turret_03.alo	Unused?	[]
evfo_onager_turret_04.alo	Unused?	[]
evfo_onager_turret_05.alo	Unused?	[]
evfo_onager_turret_06.alo	Unused?	[]
ev_acclamator_assault_ship.alo	Unused?	[]
ev_acclamator_assault_ship_d.alo	Unused?	[]
ev_allegiance.alo	Mod	['Units_Space_Empire_Allegiance.xml']
ev_allegiance_d.alo	Unused?	[]
ev_assertor_ssd.alo	Unused?	[]
ev_assertor_ssd_d.alo	Unused?	[]
ev_assertor_ssd_turret_01.alo	Unused?	[]
ev_assertor_ssd_turret_02.alo	Unused?	[]
ev_assertor_ssd_turret_03.alo	Unused?	[]
ev_assertor_ssd_turret_04.alo	Unused?	[]
ev_assertor_ssd_turret_05.alo	Unused?	[]
ev_assertor_ssd_turret_06.alo	Unused?	[]
ev_assertor_ssd_turret_07.alo	Unused?	[]
ev_assertor_ssd_turret_08.alo	Unused?	[]
ev_assertor_ssd_turret_09.alo	Unused?	[]
ev_assertor_ssd_turret_10.alo	Unused?	[]
ev_assertor_ssd_turret_100.alo	Unused?	[]
ev_assertor_ssd_turret_101.alo	Unused?	[]
ev_assertor_ssd_turret_102.alo	Unused?	[]
ev_assertor_ssd_turret_103.alo	Unused?	[]
ev_assertor_ssd_turret_104.alo	Unused?	[]
ev_assertor_ssd_turret_105.alo	Unused?	[]
ev_assertor_ssd_turret_106.alo	Unused?	[]
ev_assertor_ssd_turret_107.alo	Unused?	[]
ev_assertor_ssd_turret_108.alo	Unused?	[]
ev_assertor_ssd_turret_109.alo	Unused?	[]
ev_assertor_ssd_turret_11.alo	Unused?	[]
ev_assertor_ssd_turret_110.alo	Unused?	[]
ev_assertor_ssd_turret_111.alo	Unused?	[]
ev_assertor_ssd_turret_112.alo	Unused?	[]
ev_assertor_ssd_turret_113.alo	Unused?	[]
ev_assertor_ssd_turret_114.alo	Unused?	[]
ev_assertor_ssd_turret_115.alo	Unused?	[]
ev_assertor_ssd_turret_12.alo	Unused?	[]
ev_assertor_ssd_turret_13.alo	Unused?	[]
ev_assertor_ssd_turret_14.alo	Unused?	[]
ev_assertor_ssd_turret_15.alo	Unused?	[]
ev_assertor_ssd_turret_16.alo	Unused?	[]
ev_assertor_ssd_turret_17.alo	Unused?	[]
ev_assertor_ssd_turret_18.alo	Unused?	[]
ev_assertor_ssd_turret_19.alo	Unused?	[]
ev_assertor_ssd_turret_20.alo	Unused?	[]
ev_assertor_ssd_turret_21.alo	Unused?	[]
ev_assertor_ssd_turret_22.alo	Unused?	[]
ev_assertor_ssd_turret_23.alo	Unused?	[]
ev_assertor_ssd_turret_24.alo	Unused?	[]
ev_assertor_ssd_turret_25.alo	Unused?	[]
ev_assertor_ssd_turret_26.alo	Unused?	[]
ev_assertor_ssd_turret_27.alo	Unused?	[]
ev_assertor_ssd_turret_28.alo	Unused?	[]
ev_assertor_ssd_turret_29.alo	Unused?	[]
ev_assertor_ssd_turret_30.alo	Unused?	[]
ev_assertor_ssd_turret_31.alo	Unused?	[]
ev_assertor_ssd_turret_32.alo	Unused?	[]
ev_assertor_ssd_turret_33.alo	Unused?	[]
ev_assertor_ssd_turret_34.alo	Unused?	[]
ev_assertor_ssd_turret_35.alo	Unused?	[]
ev_assertor_ssd_turret_36.alo	Unused?	[]
ev_assertor_ssd_turret_37.alo	Unused?	[]
ev_assertor_ssd_turret_38.alo	Unused?	[]
ev_assertor_ssd_turret_39.alo	Unused?	[]
ev_assertor_ssd_turret_40.alo	Unused?	[]
ev_assertor_ssd_turret_41.alo	Unused?	[]
ev_assertor_ssd_turret_42.alo	Unused?	[]
ev_assertor_ssd_turret_43.alo	Unused?	[]
ev_assertor_ssd_turret_44.alo	Unused?	[]
ev_assertor_ssd_turret_45.alo	Unused?	[]
ev_assertor_ssd_turret_46.alo	Unused?	[]
ev_assertor_ssd_turret_47.alo	Unused?	[]
ev_assertor_ssd_turret_48.alo	Unused?	[]
ev_assertor_ssd_turret_49.alo	Unused?	[]
ev_assertor_ssd_turret_50.alo	Unused?	[]
ev_assertor_ssd_turret_51.alo	Unused?	[]
ev_assertor_ssd_turret_52.alo	Unused?	[]
ev_assertor_ssd_turret_53.alo	Unused?	[]
ev_assertor_ssd_turret_54.alo	Unused?	[]
ev_assertor_ssd_turret_55.alo	Unused?	[]
ev_assertor_ssd_turret_56.alo	Unused?	[]
ev_assertor_ssd_turret_57.alo	Unused?	[]
ev_assertor_ssd_turret_58.alo	Unused?	[]
ev_assertor_ssd_turret_59.alo	Unused?	[]
ev_assertor_ssd_turret_60.alo	Unused?	[]
ev_assertor_ssd_turret_61.alo	Unused?	[]
ev_assertor_ssd_turret_62.alo	Unused?	[]
ev_assertor_ssd_turret_63.alo	Unused?	[]
ev_assertor_ssd_turret_64.alo	Unused?	[]
ev_assertor_ssd_turret_65.alo	Unused?	[]
ev_assertor_ssd_turret_66.alo	Unused?	[]
ev_assertor_ssd_turret_67.alo	Unused?	[]
ev_assertor_ssd_turret_68.alo	Unused?	[]
ev_assertor_ssd_turret_69.alo	Unused?	[]
ev_assertor_ssd_turret_70.alo	Unused?	[]
ev_assertor_ssd_turret_71.alo	Unused?	[]
ev_assertor_ssd_turret_72.alo	Unused?	[]
ev_assertor_ssd_turret_73.alo	Unused?	[]
ev_assertor_ssd_turret_74.alo	Unused?	[]
ev_assertor_ssd_turret_75.alo	Unused?	[]
ev_assertor_ssd_turret_76.alo	Unused?	[]
ev_assertor_ssd_turret_77.alo	Unused?	[]
ev_assertor_ssd_turret_78.alo	Unused?	[]
ev_assertor_ssd_turret_79.alo	Unused?	[]
ev_assertor_ssd_turret_80.alo	Unused?	[]
ev_assertor_ssd_turret_81.alo	Unused?	[]
ev_assertor_ssd_turret_82.alo	Unused?	[]
ev_assertor_ssd_turret_83.alo	Unused?	[]
ev_assertor_ssd_turret_84.alo	Unused?	[]
ev_assertor_ssd_turret_85.alo	Unused?	[]
ev_assertor_ssd_turret_86.alo	Unused?	[]
ev_assertor_ssd_turret_87.alo	Unused?	[]
ev_assertor_ssd_turret_88.alo	Unused?	[]
ev_assertor_ssd_turret_89.alo	Unused?	[]
ev_assertor_ssd_turret_90.alo	Unused?	[]
ev_assertor_ssd_turret_91.alo	Unused?	[]
ev_assertor_ssd_turret_92.alo	Unused?	[]
ev_assertor_ssd_turret_93.alo	Unused?	[]
ev_assertor_ssd_turret_94.alo	Unused?	[]
ev_assertor_ssd_turret_95.alo	Unused?	[]
ev_assertor_ssd_turret_96.alo	Unused?	[]
ev_assertor_ssd_turret_97.alo	Unused?	[]
ev_assertor_ssd_turret_98.alo	Unused?	[]
ev_assertor_ssd_turret_99.alo	Unused?	[]
ev_at-at.alo	Mod	['Props_story.xml', 'uniqueunits.xml', 'units_land_empire_at_at_walker.xml', 'units_land_empire_at_at_walker.xml']
ev_atact.alo	Unused?	[]
ev_atar.alo	Mod	['Units_land_empire_AT_DP.xml']
ev_at_dt.alo	Unused?	[]
ev_at_mp.alo	Unused?	[]
ev_bellator.alo	Unused?	[]
ev_bellator_d.alo	Unused?	[]
ev_bike.alo	Mod	['Units_land_empire_Scout_Trooper.xml', 'units_land_mandalorian_speeder.xml']
ev_century_tank.alo	Unused?	[]
ev_century_tank_d.alo	Unused?	[]
ev_conqueror.alo	Unused?	[]
ev_corvus.alo	Unused?	[]
ev_dominion.alo	Unused?	[]
ev_eclipse.alo	Unused?	[]
ev_eclipse_sloane.alo	Mod	['Units_hero_empire_Eclipse.xml']
ev_empress.alo	Mod	['Units_hero_empire_Empress.xml']
ev_empress_d.alo	Mod	['Units_hero_empire_Empress.xml']
ev_enforcership.alo	Unused?	[]
ev_enforcership_d.alo	Unused?	[]
ev_executorstardestroyer_d.alo	Mod	['Units_space_empire_executor.xml']
ev_executor_star_dreadnaught.alo	Mod	['Units_hero_empire_Annihilator.xml', 'units_hero_empire_enforcer.xml', 'units_hero_empire_guardian.xml', 'units_hero_empire_iron_fist.xml', 'units_hero_empire_libertys_misrule.xml', 'units_hero_empire_megador.xml', 'units_hero_empire_razor_kiss.xml', 'units_hero_empire_reaper.xml', 'units_hero_empire_second_death.xml', 'units_hero_empire_terror.xml', 'units_space_empire_executor.xml']
ev_gladiator.alo	Unused?	[]
ev_gladiator_d.alo	Unused?	[]
ev_iftx.alo	Unused?	[]
ev_iftx_turret.alo	Mod	['Hardpoints.xml']
ev_immobilizer.alo	Mod	['Units_Space_Empire_Immobilizer.xml']
ev_immobilizer_dlc_01.alo	Unused?	[]
ev_immobilizer_dlc_02.alo	Unused?	[]
ev_immobilizer_dlc_03.alo	Unused?	[]
ev_immobilizer_dlc_04.alo	Unused?	[]
ev_immobilizer_dlc_05.alo	Unused?	[]
ev_immobilizer_dlc_06.alo	Unused?	[]
ev_immobilizer_dlc_07.alo	Unused?	[]
ev_immobilizer_dlc_08.alo	Unused?	[]
ev_immobilizer_dlc_09.alo	Unused?	[]
ev_immobilizer_dlc_10.alo	Unused?	[]
ev_immobilizer_dlc_11.alo	Unused?	[]
ev_immobilizer_dlc_12.alo	Unused?	[]
ev_imperialcraft.alo	Mod	['Transportunits.xml']
ev_imperialcraft_loader.alo	Unused?	[]
ev_imperialcraft_loader_space.alo	Unused?	[]
ev_imperialcraft_space.alo	Mod	['Transportunits.xml']
ev_intimidator.alo	Mod	['Units_hero_empire_Intimidator.xml', 'units_hero_empire_ravager.xml']
ev_juggernauta5.alo	Unused?	[]
ev_praetor_advanced.alo	Unused?	[]
ev_praetor_ssd.alo	Unused?	[]
ev_quasar.alo	Mod	['Units_space_empire_carrier.xml']
ev_quasar_d.alo	Unused?	[]
ev_resurgent.alo	Unused?	[]
ev_resurgent_d.alo	Unused?	[]
ev_secutor.alo	Unused?	[]
ev_secutor_t_turbo_db_prop.alo	Unused?	[]
ev_stardestroyer.alo	Mod	['Units_space_Empire_Star_Destroyer_II.xml']
ev_stardestroyer_thrawn_d.alo	Vanilla	[]
ev_stardestroyer_thrawn_hp00_b-l.alo	Mod	['Hardpoints_underworld.xml']
ev_stardestroyer_thrawn_hp00_b-r.alo	Mod	['Hardpoints_underworld.xml']
ev_stardestroyer_thrawn_hp00_e.alo	Mod	['Hardpoints_underworld.xml']
ev_stardestroyer_thrawn_hp00_f-r.alo	Mod	['Hardpoints_underworld.xml']
ev_stardestroyer_thrawn_hp00_l-f.alo	Mod	['Hardpoints_underworld.xml']
ev_stardestroyer_thrawn_hp00_m-c.alo	Mod	['Hardpoints_underworld.xml']
ev_stardestroyer_thrawn_hp00_m-l.alo	Mod	['Hardpoints_underworld.xml']
ev_stardestroyer_thrawn_hp00_m-r.alo	Mod	['Hardpoints_underworld.xml']
ev_titan_ssd.alo	Unused?	[]
ev_turbulent.alo	Unused?	[]
ev_tx_tank.alo	Unused?	[]
ev_venator.alo	Unused?	[]
ev_venator_hp_b-m.alo	Unused?	[]
ev_venator_hp_spawn_00.alo	Unused?	[]
ev_venator_hp_spawn_01.alo	Unused?	[]
ev_victory1.alo	Mod	['Units_space_empire_Victory.xml']
ev_victory1_death.alo	Unused?	[]
ev_victorystardestroyer.alo	Vanilla	[]
ev_victorystardestroyer_d.alo	Vanilla	[]
ev_victorystardestroyer_hp00_c-b.alo	Mod	['Spaceprops.xml']
ev_victorystardestroyer_hp00_c-f.alo	Mod	['Spaceprops.xml']
ev_victorystardestroyer_hp00_e.alo	Vanilla	[]
ev_victorystardestroyer_hp00_m-l.alo	Mod	['Spaceprops.xml']
ev_victorystardestroyer_hp00_m-r.alo	Mod	['Spaceprops.xml']
ev_victorystardestroyer_hulk.alo	Unused?	[]
faction_e_logo.alo	Mod	['Planets.xml']
faction_r_logo.alo	Mod	['Planets.xml']
familybase_01.alo	Unused?	[]
familybase_01_d.alo	Unused?	[]
familybase_02.alo	Unused?	[]
familybase_02_d.alo	Unused?	[]
familybase_03.alo	Unused?	[]
familybase_03_d.alo	Unused?	[]
familybase_04.alo	Unused?	[]
familybase_04_d.alo	Unused?	[]
familybase_05.alo	Unused?	[]
familybase_05_d.alo	Unused?	[]
finalizer_sd.alo	Unused?	[]
finalizer_star_destroyer.alo	Unused?	[]
freefall.alo	Unused?	[]
f_carrack.alo	Mod	['Units_space_Black_Sun_Carrack.xml', 'units_space_rebel_carrack.xml']
f_dauntless.alo	Mod	['Units_space_rebel_Dauntless.xml']
f_dreadnought.alo	Mod	['Units_space_Black_Sun_Carrack.xml', 'units_space_black_sun_katana_dreadnought.xml', 'units_space_black_sun_katana_dreadnought.xml', 'units_space_hutt_katana_dreadnought.xml', 'units_space_hutt_katana_dreadnought.xml', 'units_space_empire_katana_dreadnought.xml', 'units_space_empire_katana_dreadnought.xml', 'units_space_rebel_carrack.xml']
f_dreadnought_d.alo	Unused?	[]
f_golan1.alo	Unused?	[]
f_golan2.alo	Mod	['Units_Space_Golans.xml']
f_golan3.alo	Mod	['Units_Space_Golans.xml']
f_imp_hero.alo	Unused?	[]
f_imp_hero_d.alo	Unused?	[]
f_independence_d.alo	Unused?	[]
f_liberator.alo	Mod	['Units_Space_Rebel_Liberator_Carrier.xml']
f_lucrehulk.alo	Unused?	[]
f_lucrehulk_d.alo	Unused?	[]
f_mc104.alo	Unused?	[]
f_mc104_d.alo	Unused?	[]
f_mc40.alo	Unused?	[]
f_mc40b_d.alo	Unused?	[]
f_mc50.alo	Mod	['Units_space_rebel_mc50.xml']
f_mc50_d.alo	Unused?	[]
f_mc60_d.alo	Unused?	[]
f_mc75.alo	Mod	['Units_space_rebel_mc75.xml']
f_mc75_d.alo	Unused?	[]
f_mc80a_d.alo	Unused?	[]
f_mc80b_d.alo	Unused?	[]
f_mc80c_d.alo	Unused?	[]
f_mc85_d.alo	Unused?	[]
f_mc90.alo	Unused?	[]
f_mc90b.alo	Mod	['Units_space_rebel_mc90.xml', 'units_space_rebel_mc90b.xml']
f_mc90_d.alo	Unused?	[]
f_munificent.alo	Mod	['Units_Space_Crimson_Dawn_Munificent.xml']
f_nebulonb.alo	Mod	['Uniqueunits.xml', 'units_space_black_sun_nebulon_b.xml', 'units_space_hutt_nebulon_b.xml', 'units_space_rebel_nebulon_b.xml']
f_nebulonb2.alo	Unused?	[]
f_providence.alo	Mod	['Units_Space_Confederacy_Providence.xml']
f_providence_d.alo	Unused?	[]
f_recusant.alo	Unused?	[]
f_recusant_d.alo	Unused?	[]
f_strident.alo	Unused?	[]
f_strident_d.alo	Unused?	[]
f_thrawnsd.alo	Unused?	[]
f_thrawnsd_d.alo	Unused?	[]
f_titan.alo	Unused?	[]
f_titan_d.alo	Unused?	[]
f_victory.alo	Unused?	[]
f_victoryii.alo	Mod	['Units_space_empire_VictoryII.xml']
f_victoryiii.alo	Mod	['Units_space_empire_VictoryIII.xml']
f_victory_d.alo	Unused?	[]
gargantuan_advanced.alo	Unused?	[]
gargantuan_advanced_platform.alo	Mod	['Units_land_rebel_gargantuan_advanced.xml']
gargantuan_platform.alo	Unused?	[]
gauntlet.alo	Unused?	[]
golan1_station.alo	Mod	['Units_Space_Golans.xml']
golan2_station.alo	Unused?	[]
golan3_station.alo	Unused?	[]
gozanti.alo	Unused?	[]
gozanti_black_sun.alo	Mod	['Units_space_Crimson_Dawn_Gozanti.xml']
gozanti_empire.alo	Mod	['Units_space_Black_Sun_Gozanti.xml', 'units_space_crimson_dawn_gozanti.xml', 'units_space_hutt_gozanti.xml', 'units_space_hutt_gozanti.xml', 'units_space_empire_gozanti.xml', 'units_space_empire_gozanti.xml']
gozanti_empire_01.alo	Mod	['Units_space_Crimson_Dawn_Gozanti.xml']
gozanti_empire_02.alo	Mod	['Units_space_Black_Sun_Gozanti.xml', 'units_space_crimson_dawn_gozanti.xml', 'units_space_crimson_dawn_gozanti.xml', 'units_space_hutt_gozanti.xml', 'units_space_hutt_gozanti.xml', 'units_space_empire_gozanti.xml', 'units_space_empire_gozanti.xml']
hammerhead_corvette.alo	Mod	['Units_Space_Rebel_Hammerhead.xml']
havoc.alo	Unused?	[]
himera_star_destroyer.alo	Unused?	[]
hlp_layerz.alo	Unused?	[]
hp_leftshieldgen_00.alo	Mod	['Hardpoints_underworld.xml', 'hardpoints_gargantuan.xml', 'hardpoints_gargantuan_advanced.xml']
hp_rightshieldgen_00.alo	Mod	['Hardpoints_underworld.xml', 'hardpoints_gargantuan.xml', 'hardpoints_gargantuan_advanced.xml']
hp_turret_back_00.alo	Mod	['Hardpoints_underworld.xml', 'hardpoints_gargantuan.xml', 'hardpoints_gargantuan_advanced.xml']
hp_turret_back_l_00.alo	Mod	['Hardpoints_underworld.xml', 'hardpoints_gargantuan.xml', 'hardpoints_gargantuan_advanced.xml']
hp_turret_back_r_00.alo	Mod	['Hardpoints_underworld.xml', 'hardpoints_gargantuan.xml', 'hardpoints_gargantuan_advanced.xml']
hp_turret_front_00.alo	Mod	['Hardpoints_underworld.xml', 'hardpoints_gargantuan.xml', 'hardpoints_gargantuan_advanced.xml']
hp_turret_front_l_00.alo	Mod	['Hardpoints_underworld.xml', 'hardpoints_gargantuan.xml', 'hardpoints_gargantuan_advanced.xml']
hp_turret_front_r_00.alo	Mod	['Hardpoints_underworld.xml', 'hardpoints_gargantuan.xml', 'hardpoints_gargantuan_advanced.xml']
hutt_cruiser.alo	Mod	['Units_Space_Hutt_Cruiser.xml']
hutt_cruiser_d.alo	Mod	['Units_Space_Hutt_Cruiser.xml']
hutt_dagger.alo	Unused?	[]
hu_hvy_sail_barge.alo	Mod	['Units_Land_Hutts_SailBarge.xml']
hu_hvy_sail_barge_turret_00.alo	Mod	['Hardpoints_Sailbarge.xml']
hu_hvy_sail_barge_turret_01.alo	Mod	['Hardpoints_Sailbarge.xml']
hu_hvy_sail_barge_turret_02.alo	Mod	['Hardpoints_Sailbarge.xml']
hu_hvy_sail_barge_turret_03.alo	Mod	['Hardpoints_Sailbarge.xml']
hu_multi_skiff.alo	Unused?	[]
hu_pirate_speeder_2.alo	Mod	['Units_land_Black_Sun_Pirate_Tank.xml']
hvycruiser3.alo	Unused?	[]
icon_ev_victorystardestroyer.alo	Unused?	[]
imperial_i-class_star_destroyer.alo	Mod	['Units_space_Empire_Star_Destroyer_I.xml', 'units_space_empire_star_destroyer_ii.xml', 'units_space_empire_star_destroyer_iii.xml', 'units_space_empire_tector.xml', 'units_space_empire_xyston.xml']
imperial_ii-class_star_destroyer.alo	Mod	['Units_Hero_Empire_Titan_Squadron.xml', 'units_space_empire_star_destroyer_ii.xml', 'units_space_empire_star_destroyer_iii.xml']
imperial_ii-class_star_destroyer_black.alo	Unused?	[]
imperious.alo	Unused?	[]
imperious_d.alo	Unused?	[]
imp_light_cruiser.alo	Mod	['Units_Space_Black_Sun_Arquitens.xml', 'units_space_hutt_arquitens.xml', 'units_space_hutt_arquitens.xml', 'units_space_arquitens.xml', 'units_space_arquitens.xml']
imp_light_cruiser_d.alo	Unused?	[]
imp_tie_bomber.alo	Mod	['Spaceunitsfighters.xml']
imp_tie_defender.alo	Mod	['Units_space_empire_tie_defender.xml']
imp_tie_fighter.alo	Mod	['Spaceunitsfighters.xml']
imp_tie_interceptor.alo	Mod	['Units_space_empire_tie_interceptor.xml']
interceptoriv.alo	Unused?	[]
i_cis_station_level1.alo	Unused?	[]
i_cis_station_level2.alo	Unused?	[]
i_cis_station_level3.alo	Unused?	[]
i_cis_station_level4.alo	Unused?	[]
i_cis_station_level5.alo	Unused?	[]
i_galactic_organize.alo	Vanilla	[]
i_rb_station_level1.alo	Mod	['Starbases.xml']
i_rb_station_level2.alo	Mod	['Starbases.xml']
i_rb_station_level3.alo	Mod	['Starbases.xml']
i_rb_station_level4.alo	Mod	['Starbases.xml']
i_rb_station_level5.alo	Mod	['Starbases.xml']
i_rep_starbase_golan.alo	Unused?	[]
i_rep_starbase_juma_9.alo	Unused?	[]
i_rep_starbase_level_01.alo	Unused?	[]
i_rep_starbase_level_02.alo	Unused?	[]
i_rep_starbase_level_03.alo	Unused?	[]
i_rep_starbase_level_04.alo	Unused?	[]
i_rep_starbase_level_05.alo	Unused?	[]
kandosii.alo	Mod	['Units_Space_Mandalorian_Kandosii.xml', 'units_space_mandalorian_kandosii2.xml', 'units_space_mandalorian_kandosii2.xml']
kedalbebattleship.alo	Unused?	[]
knight_hammer.alo	Mod	['Units_hero_empire_Knight_Hammer.xml']
kraytclassdestroyer.alo	Unused?	[]
layer_z_dummy.alo	Mod	['LayerZDummy.xml']
lucrehulk.alo	Mod	['Units_Space_Confederacy_Lucrehulk.xml']
mandalorian_cruiser1.alo	Unused?	[]
mandalorian_cruiser2.alo	Unused?	[]
mandalorian_speeder.alo	Mod	['Units_Land_Mandalorian_Speeder.xml']
mandator_pirates.alo	Mod	['Units_hero_Black_Sun_Xizor.xml']
mandator_super_star_destroyer.alo	Unused?	[]
mc104.alo	Unused?	[]
mc104_star_dreadnaught.alo	Unused?	[]
mc112_star_cruiser.alo	Unused?	[]
mc30_ardent-class_frigate.alo	Unused?	[]
mc40.alo	Mod	['Units_space_rebel_mc40.xml']
mc40b.alo	Mod	['Units_space_rebel_mc40b_frigate.xml']
mc50.alo	Mod	['Units_space_rebel_mc50.xml']
mc60.alo	Mod	['Units_space_rebel_mc60.xml']
mc75.alo	Mod	['Units_space_rebel_mc75.xml']
mc75_profundity.alo	Mod	['Uniqueunits.xml', 'units_hero_rebel_vanguard_squadron.xml', 'units_space_rebel_profundity.xml', 'units_space_rebel_profundity.xml']
mc80a_wingless.alo	Mod	['Units_space_rebel_mc80A_Wingless.xml']
mc80b.alo	Mod	['Units_space_rebel_mc80b.xml']
mc80c.alo	Mod	['Units_space_rebel_mc80b.xml']
mc80wingless.alo	Unused?	[]
mc80_a.alo	Mod	['Units_space_rebel_mc80A_Wingless.xml']
mc80_home_one.alo	Mod	['Uniqueunits.xml']
mc80_liberty.alo	Mod	['Units_Space_Rebel_mc80_Liberty.xml']
mc80_wingless.alo	Unused?	[]
mc85.alo	Unused?	[]
mc85_star_destroyer.alo	Unused?	[]
mc90b_star_destroyer.alo	Mod	['Units_space_rebel_mc90b.xml']
mc90_star_destroyer.alo	Mod	['Units_space_rebel_mc90.xml']
mc_blue_diver.alo	Mod	['Units_space_rebel_MonCalHC.xml']
mediator_dreadnaught.alo	Unused?	[]
mi_deathwatch_light.alo	Mod	['Units_land_Mandalorian_Death_Watch.xml']
mi_death_watch_commander.alo	Mod	['Units_land_Mandalorian_Commander.xml']
mi_death_watch_lieutenant.alo	Mod	['Units_land_Mandalorian_Lieutenant.xml']
mi_rocket_trooper.alo	Mod	['Units_land_Mandalorian_Plex.xml']
mi_supercommando_captain.alo	Mod	['Units_land_Crimson_Dawn_Super_Commando.xml', 'units_land_mandalorian_super_commando.xml', 'units_land_mandalorian_super_commando.xml', 'units_land_mandalorian_super_commando.xml']
munificent.alo	Mod	['Units_Space_Confederacy_Munificent.xml']
munificent_frigate.alo	Unused?	[]
mv_kandosii.alo	Unused?	[]
m_i_mando_soldier.alo	Mod	['Units_land_Mandalorian_mandalorianinf.xml']
m_snipertrooper.alo	Mod	['Units_land_Mandalorian_Snipers.xml']
nb_black_sun_bmphq.alo	Unused?	[]
nb_sluis_van.alo	Unused?	[]
nb_the_wheel.alo	Unused?	[]
new_alderaan_defender.alo	Unused?	[]
ni_barc.alo	Unused?	[]
ni_falleen.alo	Unused?	[]
ni_princexizor.alo	Unused?	[]
nr_dauntless.alo	Mod	['Units_space_rebel_Dauntless.xml']
nv_dread_die.alo	Unused?	[]
nv_factory.alo	Unused?	[]
nv_jovan_station.alo	Mod	['Units_Space_Golans.xml']
nv_jovan_station_d.alo	Unused?	[]
nv_podwalker.alo	Mod	['Units_land_Black_Sun_Pod_Walker.xml', 'units_land_hutts_pod_walker.xml', 'units_land_hutts_pod_walker.xml']
nv_vwing_republic.alo	Unused?	[]
onager_star_destroyer.alo	Unused?	[]
pd_explosion_ship_new.alo	Mod	['Particles.xml']
pd_explosion_ship_new_land.alo	Mod	['Particles.xml']
pd_medium_3_1250.alo	Unused?	[]
pd_medium_3_150.alo	Mod	['empire_immobilizer_418.alo', 'empire_vindicator.alo']
pd_new_explosion_large_heat_land.alo	Mod	['Particles.xml']
pd_new_explosion_medium.alo	Unused?	[]
pd_new_explosion_medium_heat.alo	Mod	['Particles.xml']
pd_new_explosion_medium_heat_land.alo	Mod	['Particles.xml']
pd_new_explosion_small_heat.alo	Mod	['Particles.xml']
pd_new_explosion_small_heat_land.alo	Mod	['Particles.xml']
pd_new_explosion_super_small_heat_land.alo	Mod	['Particles.xml']
pd_new_explosion_super_small_heat_land_turret.alo	Mod	['Particles.xml']
pelleaon.alo	Unused?	[]
pelleaon_d.alo	Unused?	[]
pelleaon_star_destroyer.alo	Unused?	[]
pelleaon_turret_01.alo	Unused?	[]
pelleaon_turret_02.alo	Unused?	[]
pelleaon_turret_03.alo	Unused?	[]
pelleaon_turret_04.alo	Unused?	[]
pelleaon_turret_05.alo	Unused?	[]
pelleaon_turret_06.alo	Unused?	[]
pelleaon_turret_07.alo	Unused?	[]
pe_allegiance.alo	Mod	['ev_allegiance.alo']
pe_allegiance_star_destroyer_large.alo	Unused?	[]
pe_allegiance_star_destroyer_small.alo	Unused?	[]
pe_annihilator_star_destroyer_large.alo	Unused?	[]
pe_annihilator_star_destroyer_medium.alo	Unused?	[]
pe_annihilator_star_destroyer_small.alo	Unused?	[]
pe_ardent-class_engines_medium.alo	Mod	['mc30_ardent-class_frigate.alo']
pe_ardent-class_engines_small.alo	Mod	['mc30_ardent-class_frigate.alo']
pe_ardent-class_engine_large.alo	Mod	['mc30_ardent-class_frigate.alo']
pe_assertor.alo	Mod	['assertor_super_star_destroyer.alo', 'ev_assertor_ssd.alo']
pe_awingenginesland.alo	Mod	['hu_pirate_speeder_2.alo']
pe_bloodstar_l.alo	Mod	['bloodstar.alo']
pe_bloodstar_m.alo	Mod	['bloodstar.alo']
pe_bloodstar_s.alo	Mod	['bloodstar.alo']
pe_blue_diver_l.alo	Mod	['blue_diver.alo', 'mc_blue_diver.alo']
pe_blue_diver_m.alo	Mod	['blue_diver.alo', 'mc_blue_diver.alo']
pe_blue_diver_s.alo	Mod	['blue_diver.alo', 'mc_blue_diver.alo']
pe_carrack_cruiser.alo	Unused?	[]
pe_engine_v20.alo	Mod	['ev_gladiator.alo']
pe_engine_w1.alo	Mod	['rvre_vigil.alo']
pe_engine_w10.alo	Mod	['evfo_onager.alo', 'onager_star_destroyer.alo']
pe_engine_w15.alo	Mod	['evfo_onager.alo', 'onager_star_destroyer.alo']
pe_engine_w20.alo	Mod	['mc80wingless.alo', 'mc80_wingless.alo', 'rvre_starhawk.alo', 'rv_mc80ajm.alo', 'rv_mc80wl.alo']
pe_engine_w3.alo	Mod	['rvre_vigil.alo']
pe_engine_w30.alo	Mod	['rvre_starhawk.alo']
pe_engine_w45.alo	Mod	['rvre_starhawk.alo']
pe_engine_w6.alo	Mod	['rvre_vigil.alo']
pe_executor.alo	Mod	['age_of_strife.alo', 'arbitrator.alo', 'death_lives.alo', 'ev_eclipse_sloane.alo', 'ev_empress.alo', 'ev_executor_star_dreadnaught.alo', 'ev_intimidator.alo', 'knight_hammer.alo', 'mandator_pirates.alo', 'release_the_fury.alo', 'rv_lusankya.alo', 'vengeance.alo', 'wrath_of_war.alo']
pe_finalizer_l.alo	Mod	['finalizer_sd.alo']
pe_finalizer_s.alo	Mod	['finalizer_sd.alo']
pe_freefall.alo	Mod	['freefall.alo']
pe_gozanti_l.alo	Mod	['gozanti.alo', 'gozanti_black_sun.alo', 'gozanti_empire.alo', 'gozanti_empire_01.alo', 'gozanti_empire_02.alo']
pe_gozanti_s.alo	Mod	['gozanti.alo', 'gozanti_black_sun.alo', 'gozanti_empire.alo', 'gozanti_empire_01.alo', 'gozanti_empire_02.alo']
pe_hammerhead_corvette.alo	Mod	['hammerhead_corvette.alo']
pe_havoc_lrg.alo	Mod	['havoc.alo']
pe_havoc_sml.alo	Mod	['havoc.alo']
pe_hutt_cruiser.alo	Mod	['hutt_cruiser.alo']
pe_hutt_dagger_engine01.alo	Mod	['hutt_dagger.alo']
pe_hutt_dagger_engine02.alo	Mod	['hutt_dagger.alo']
pe_iec.alo	Unused?	[]
pe_imperial-class_engines_large.alo	Mod	['dominator_i-class_star_destroyer.alo', 'ev_conqueror.alo', 'himera_star_destroyer.alo', 'imperial_i-class_star_destroyer.alo', 'imperial_ii-class_star_destroyer.alo', 'imperial_ii-class_star_destroyer_black.alo', 'tector_star_destroyer.alo', 'xyston_destroyer.alo', 'xyston_destroyerii.alo']
pe_imperial_star_destroyer_large.alo	Mod	['empire_dominator_star_destroyer.alo']
pe_imperial_star_destroyer_small.alo	Mod	['empire_dominator_star_destroyer.alo']
pe_implacableengines.alo	Unused?	[]
pe_implacable_med.alo	Unused?	[]
pe_implacable_sml.alo	Mod	['dreadnoughtiv.alo']
pe_kandosii_l.alo	Unused?	[]
pe_kandosii_s.alo	Unused?	[]
pe_light_cruiser.alo	Mod	['rep_light_cruiser.alo']
pe_mc112x1.alo	Mod	['rv_mc108.alo', 'rv_mc112.alo']
pe_mc112x2.alo	Mod	['rv_mc108.alo', 'rv_mc112.alo']
pe_mc112x3.alo	Mod	['rv_mc108.alo', 'rv_mc112.alo']
pe_mc_80_wl_l.alo	Unused?	[]
pe_mc_80_wl_m.alo	Unused?	[]
pe_mc_80_wl_s.alo	Unused?	[]
pe_mc_mediator.alo	Mod	['rebel_mon_calamari_mediator.alo']
pe_mediator.alo	Mod	['mediator_dreadnaught.alo', 'rv_mediator.alo', 'rv_mediator_battlecruiser.alo']
pe_megator.alo	Unused?	[]
pe_megator_sml.alo	Unused?	[]
pe_pelleaon_01.alo	Mod	['imperious.alo', 'pelleaon.alo', 'pelleaon_star_destroyer.alo']
pe_pelleaon_02.alo	Mod	['imperious.alo', 'pelleaon.alo', 'pelleaon_star_destroyer.alo']
pe_pelta.alo	Mod	['reb_pelta_carrier.alo', 'rep_pelta.alo']
pe_pelta_b.alo	Unused?	[]
pe_pirate_speeder.alo	Mod	['pirate_speeder.alo']
pe_praetor_s.alo	Unused?	[]
pe_predator.alo	Mod	['ev_secutor.alo', 'rv_mc85.alo']
pe_predatorsml.alo	Mod	['ev_secutor.alo', 'raddus_star_cruiser.alo', 're_raddus.alo', 'rvre_raddus.alo', 'rv_mc85.alo']
pe_profundity_l.alo	Mod	['profundity.alo']
pe_profundity_s.alo	Unused?	[]
pe_raider_l.alo	Mod	['ev_corvus.alo', 'raider_corvette.alo']
pe_raider_s.alo	Mod	['ev_corvus.alo', 'raider_corvette.alo']
pe_relentless.alo	Mod	['ev_resurgent.alo']
pe_secutor_l.alo	Unused?	[]
pe_secutor_s.alo	Unused?	[]
pe_stardestroyerengines_thrawn.alo	Unused?	[]
pe_titan_sd_l.alo	Unused?	[]
pe_titan_sd_s.alo	Unused?	[]
pe_turbulent_small.alo	Mod	['ev_turbulent.alo', 'turbulent_star_destroyer.alo']
pe_u_wing.alo	Unused?	[]
pe_venator_l.alo	Unused?	[]
pe_victoryengines.alo	Mod	['ev_victorystardestroyer.alo', 'icon_ev_victorystardestroyer.alo']
pe_vindicator_l.alo	Mod	['empire_immobilizer_418.alo', 'empire_vindicator.alo']
pe_vindicator_s.alo	Mod	['empire_immobilizer_418.alo', 'empire_vindicator.alo']
pe_viscount_l.alo	Mod	['dark_mercy_star_defender.alo', 'new_alderaan_defender.alo', 'rv_salvator.alo', 'rv_viscount_class_star_defender.alo', 'viscount.alo']
pe_viscount_m.alo	Mod	['dark_mercy_star_defender.alo', 'new_alderaan_defender.alo', 'rv_salvator.alo', 'rv_viscount_class_star_defender.alo', 'viscount.alo']
pe_viscount_s.alo	Mod	['dark_mercy_star_defender.alo', 'new_alderaan_defender.alo', 'rv_salvator.alo', 'rv_viscount_class_star_defender.alo', 'viscount.alo']
pe_vwing.alo	Mod	['v-wing.alo']
pe_zyggerian.alo	Unused?	[]
pf_small_w.alo	Mod	['empire_dominator_star_destroyer.alo', 'empire_immobilizer_418.alo', 'empire_shieldgate_lvl1.alo', 'empire_shieldgate_lvl2.alo', 'empire_shieldgate_lvl3.alo', 'empire_shieldgate_lvl4.alo', 'empire_shieldgate_lvl5.alo', 'empire_vindicator.alo']
pf_small_y.alo	Mod	['empire_immobilizer_418.alo', 'empire_vindicator.alo']
pgw_grav_well_immobilizer.alo	Mod	['empire_immobilizer_418.alo']
pirate_speeder.alo	Mod	['Units_Land_Black_Sun_Pirate_Speeder.xml', 'units_land_hutts_pirate_speeder.xml']
pi_damage_elec_frigate.alo	Mod	['mc30_ardent-class_frigate.alo']
pi_damage_elec_sd01.alo	Mod	['mv_kandosii.alo']
pl_laser_b.alo	Unused?	[]
pl_turbolaser_b.alo	Unused?	[]
pl_turbolaser_c.alo	Unused?	[]
pl_turbolaser_g.alo	Unused?	[]
pl_turbolaser_m.alo	Unused?	[]
pl_turbolaser_r.alo	Unused?	[]
pl_turbolaser_y.alo	Unused?	[]
pptw_power_to_weapons4.alo	Mod	['nv_jovan_station.alo']
pptw_power_to_weapons5.alo	Unused?	[]
pptw_power_to_weapons6.alo	Mod	['mc80wingless.alo', 'mc80_wingless.alo', 'rv_mc80ajm.alo', 'rv_mc80wl.alo']
pptw_ptwsa4.alo	Mod	['bellator_super_star_destroyer.alo', 'ev_allegiance.alo', 'ev_bellator.alo', 'ev_enforcership.alo', 'ev_gladiator.alo', 'ev_secutor.alo', 'mc112_star_cruiser.alo', 'raddus_star_cruiser.alo', 're_raddus.alo', 'rvre_raddus.alo', 'rv_mc108.alo', 'rv_mc112.alo', 'rv_mediator.alo', 'secutor_star_destroyer.alo', 'vindicator.alo', 'vindicator_sd.alo']
pptw_ptwsa8.alo	Mod	['ar_nv_golani.alo', 'ar_nv_golanii.alo', 'ar_nv_golaniii.alo']
pp_assault_missile.alo	Unused?	[]
pp_bigger_boom_boom_cannon.alo	Mod	['Projectiles.xml']
pp_concussion_missile_b.alo	Unused?	[]
praetor_advanced.alo	Unused?	[]
profundity.alo	Unused?	[]
profundity_d.alo	Unused?	[]
proj_laser_blue_hand.alo	Mod	['Projectiles_Land.xml']
proj_laser_green_hand.alo	Mod	['Projectiles_Land.xml']
proj_laser_green_inf.alo	Mod	['Projectiles.xml']
proj_laser_red_g.alo	Mod	['Projectiles.xml']
proj_laser_red_hand.alo	Mod	['Projectiles_Land.xml']
proj_laser_red_inf.alo	Mod	['Projectiles.xml']
proj_laser_yellow_f.alo	Mod	['Projectiles.xml']
proj_laser_yellow_hand.alo	Mod	['Projectiles_Land.xml']
proj_maser_blue_f.alo	Mod	['Projectiles.xml']
proj_vehicle_laser_blue1.alo	Mod	['Projectiles.xml']
proj_vehicle_laser_green1.alo	Mod	['Projectiles.xml']
proj_vehicle_laser_red1.alo	Mod	['Projectiles.xml']
providence.alo	Mod	['Units_Space_Confederacy_Providence.xml']
ps_turbolaser.alo	Mod	['Particles.xml']
pte_acclamatorfalse.alo	Mod	['ev_acclamator_assault_ship.alo']
pte_aclamatormkii.alo	Mod	['ev_acclamator_assault_ship.alo']
pte_awingenginesland.alo	Mod	['hu_pirate_speeder_2.alo']
pte_blue_diver_sml.alo	Mod	['ev_secutor.alo']
pte_engine_w1.alo	Mod	['rvre_vigil.alo']
pte_engine_w6_false.alo	Mod	['rvre_vigil.alo']
pte_imperial-class_engines_small.alo	Mod	['dominator_i-class_star_destroyer.alo', 'ev_conqueror.alo', 'himera_star_destroyer.alo', 'imperial_i-class_star_destroyer.alo', 'imperial_ii-class_star_destroyer.alo', 'imperial_ii-class_star_destroyer_black.alo', 'xyston_destroyer.alo', 'xyston_destroyerii.alo']
pte_mc85.alo	Mod	['ev_secutor.alo', 'raddus_star_cruiser.alo', 're_raddus.alo', 'rvre_raddus.alo']
pte_mc85x.alo	Unused?	[]
pte_nebulonb2.alo	Mod	['ev_gladiator.alo', 'rv_assault_frigatemkiiix.alo']
pte_pelta_b.alo	Unused?	[]
pte_pelta_s.alo	Unused?	[]
pte_power_to_weapons6.alo	Mod	['rv_mc85.alo']
pte_raider_l.alo	Mod	['ev_corvus.alo', 'raider_corvette.alo']
pte_raider_s.alo	Mod	['ev_corvus.alo', 'raider_corvette.alo']
pte_u_wing.alo	Mod	['rv_uwing.alo', 'rv_uwing_blue.alo', 'rv_uwing_landing.alo']
pte_victory2.alo	Mod	['mc80wingless.alo', 'mc80_wingless.alo', 'rv_mc80ajm.alo', 'rv_mc80wl.alo', 'uv_invencible.alo']
pw_beam_r_l.alo	Unused?	[]
p_atmosphere.alo	Unused?	[]
p_aureola_laser_small_yellow.alo	Mod	['w_laser_smally.alo']
p_blue_beam.alo	Mod	['p_blue_beam_grnd.alo']
p_blue_beam_grnd.alo	Mod	['Projectiles.xml']
p_blue_blaster_sml_hand.alo	Mod	['Projectiles.xml']
p_concussion_ground_generic.alo	Mod	['w_concussion_missile_ground_generic_white.alo']
p_damage_turbolaser_bombardment_green.alo	Mod	['Particles.xml']
p_damage_turbolaser_bombardment_red.alo	Mod	['Particles.xml']
p_damage_turbolaser_miss_large_blue.alo	Mod	['Particles.xml']
p_damage_turbolaser_miss_large_green.alo	Mod	['Particles.xml']
p_damage_turbolaser_miss_large_red.alo	Mod	['Particles.xml']
p_damage_turbolaser_miss_large_yellow.alo	Mod	['Particles.xml']
p_damage_turbolaser_miss_medium_blue.alo	Mod	['Particles.xml']
p_damage_turbolaser_miss_medium_green.alo	Mod	['Particles.xml']
p_damage_turbolaser_miss_medium_red.alo	Mod	['Particles.xml']
p_damage_turbolaser_miss_medium_yellow.alo	Mod	['Particles.xml']
p_damage_turbolaser_miss_small_blue.alo	Mod	['Particles.xml']
p_damage_turbolaser_miss_small_green.alo	Mod	['Particles.xml']
p_damage_turbolaser_miss_small_red.alo	Mod	['Particles.xml']
p_damage_turbolaser_miss_small_yellow.alo	Mod	['Particles.xml']
p_deathstar_laser_large.alo	Unused?	[]
p_deathstar_laser_small.alo	Unused?	[]
p_explosion_capital.alo	Mod	['Particles.xml']
p_explosion_capital_land.alo	Mod	['Particles.xml']
p_explosion_concussion_small.alo	Mod	['Particles.xml']
p_explosion_ion_small.alo	Unused?	[]
p_e_orbital_blast.alo	Mod	['Particles.xml']
p_fighterflash_blue.alo	Mod	['proj_maser_blue_f.alo', 'proj_vehicle_laser_blue1.alo']
p_flamethrower00.alo	Mod	['ei_bobafett.alo', 'mi_death_watch_lieutenant.alo', 'Projectiles.xml', 'projectiles_land.xml']
p_flamethrower00b.alo	Mod	['ei_darktrooper.alo']
p_heat_glowr.alo	Unused?	[]
p_hp_alliancex1.alo	Mod	['cis_station_level1_d.alo', 'cis_station_level2_d.alo', 'cis_station_level3_d.alo', 'cis_station_level4.alo', 'cis_station_level4_d.alo', 'cis_station_level5.alo', 'cis_station_level5_d.alo', 'dreadnoughtiv.alo', 'evfo_onager.alo', 'evfo_onager_d.alo', 'ev_allegiance_d.alo', 'ev_assertor_ssd.alo', 'ev_bellator.alo', 'ev_secutor.alo', 'mc80wingless.alo', 're_raddus.alo', 'rvre_raddus.alo', 'rvre_starhawk.alo', 'rvre_starhawk_d.alo', 'rv_mc108.alo', 'rv_mc112.alo', 'rv_mc80ajm.alo', 'rv_mediator.alo', 'rv_mediator_d.alo', 'uv_invencible.alo']
p_hp_alliancex10.alo	Mod	['ev_resurgent.alo', 'ev_resurgent_d.alo']
p_hp_alliancex11.alo	Mod	['ev_resurgent_d.alo']
p_hp_alliancex2.alo	Mod	['ar_nv_golani.alo', 'ar_nv_golanii.alo', 'ar_nv_golaniii.alo', 'cis_station_level1_d.alo', 'cis_station_level2_d.alo', 'cis_station_level3_d.alo', 'cis_station_level4.alo', 'cis_station_level4_d.alo', 'cis_station_level5.alo', 'cis_station_level5_d.alo', 'dreadnoughtiv.alo', 'evfo_onager.alo', 'evfo_onager_d.alo', 'ev_acclamator_assault_ship.alo', 'ev_allegiance_d.alo', 'ev_assertor_ssd.alo', 'ev_bellator.alo', 'ev_enforcership.alo', 'ev_gladiator.alo', 'ev_resurgent.alo', 'ev_resurgent_d.alo', 'ev_secutor.alo', 'mc80wingless.alo', 're_raddus.alo', 'rvre_raddus.alo', 'rvre_starhawk.alo', 'rvre_starhawk_d.alo', 'rvre_vigil.alo', 'rv_assault_frigatemkiiix.alo', 'rv_mc108.alo', 'rv_mc112.alo', 'rv_mc80ajm.alo', 'rv_mc85.alo', 'rv_mc85_d.alo', 'rv_mediator.alo', 'rv_mediator_d.alo', 'uv_invencible.alo', 'vindicator.alo', 'w_kuat_ring_new_part02.alo', 'w_kuat_ring_new_part03.alo', 'w_kuat_ring_new_part04.alo', 'w_kuat_ring_new_part05.alo', 'w_planet_kuat.alo']
p_hp_alliancex3.alo	Mod	['evfo_onager.alo', 'evfo_onager_d.alo', 'ev_acclamator_assault_ship.alo', 'ev_enforcership.alo', 'ev_gladiator.alo', 'mc80wingless.alo', 'rvre_starhawk.alo', 'rvre_starhawk_d.alo', 'rvre_vigil.alo', 'rv_assault_frigatemkiiix.alo', 'rv_mc80ajm.alo', 'rv_mc85.alo', 'vindicator.alo']
p_hp_alliancex3_death.alo	Mod	['rv_mc85_d.alo']
p_hp_alliancex4.alo	Mod	['ev_assertor_ssd.alo', 'ev_bellator.alo', 'ev_secutor.alo']
p_hp_alliancex5.alo	Mod	['ar_nv_golani.alo', 'ar_nv_golanii.alo', 'ar_nv_golaniii.alo', 'dreadnoughtiv.alo', 'evfo_onager.alo', 'evfo_onager_d.alo', 'ev_resurgent_d.alo', 're_raddus.alo', 'rvre_raddus.alo']
p_hp_alliancex6.alo	Mod	['ar_nv_golani.alo', 'ar_nv_golanii.alo', 'ar_nv_golaniii.alo', 'cis_station_level3_d.alo', 'cis_station_level4.alo', 'cis_station_level4_d.alo', 'cis_station_level5.alo', 'cis_station_level5_d.alo', 're_raddus.alo', 'rvre_raddus.alo', 'w_kuat_ring_new_part02.alo', 'w_kuat_ring_new_part03.alo', 'w_kuat_ring_new_part04.alo', 'w_kuat_ring_new_part05.alo', 'w_kuat_ring_new_part06.alo', 'w_kuat_ring_new_part07.alo', 'w_planet_kuat.alo']
p_hp_alliancex8.alo	Mod	['cis_station_level1_d.alo', 'cis_station_level2_d.alo', 'cis_station_level3_d.alo', 'cis_station_level4.alo', 'cis_station_level4_d.alo', 'cis_station_level5.alo', 'cis_station_level5_d.alo']
p_hp_firestationx1.alo	Mod	['ar_nv_golani.alo', 'ar_nv_golanii.alo', 'ar_nv_golaniii.alo', 'ev_resurgent.alo', 'ev_resurgent_d.alo']
p_hp_smoke_damage_00.alo	Mod	['mv_kandosii.alo']
p_hp_starbase_damage.alo	Unused?	[]
p_hvy_art_isd_gun.alo	Mod	['Projectiles.xml']
p_hvy_art_isd_gun_r_max.alo	Mod	['Projectiles.xml']
p_inf_flash_green.alo	Mod	['proj_laser_green_inf.alo', 'proj_laser_yellow_f.alo', 'proj_vehicle_laser_green1.alo']
p_inf_flash_red.alo	Mod	['proj_laser_red_inf.alo', 'proj_vehicle_laser_red1.alo']
p_ionshot.alo	Unused?	[]
p_laseriyx_barrage.alo	Unused?	[]
p_laser_b.alo	Unused?	[]
p_laser_blue_l.alo	Mod	['Projectiles.xml']
p_laser_blue_m.alo	Mod	['Projectiles.xml']
p_laser_blue_s.alo	Mod	['Projectiles.xml']
p_laser_glow_generic.alo	Unused?	[]
p_laser_medium_blue.alo	Mod	['Projectiles.xml']
p_orbital_blast.alo	Unused?	[]
p_orbital_blast_blue.alo	Mod	['Particles.xml']
p_orbital_blast_green.alo	Mod	['Particles.xml']
p_orbital_blast_red.alo	Mod	['Particles.xml']
p_orbital_blast_yellow.alo	Mod	['Particles.xml']
p_planet_atmosphere_blue.alo	Mod	['w_planet_alderaan.alo', 'w_planet_datomir.alo', 'w_planet_desert.alo', 'w_planet_endor.alo', 'w_planet_eriadu.alo', 'w_planet_forest.alo', 'w_planet_geonosis.alo', 'w_planet_ice.alo', 'w_planet_kamino.alo', 'w_planet_kuat.alo', 'w_planet_mustafar1.alo', 'w_planet_mustafar2.alo', 'w_planet_ocean.alo', 'w_planet_prop_aargau.alo', 'w_planet_prop_achto.alo', 'w_planet_prop_alderaan.alo', 'w_planet_prop_anaxes.alo', 'w_planet_prop_anoat.alo', 'w_planet_prop_belkadan.alo', 'w_planet_prop_byss.alo', 'w_planet_prop_crait.alo', 'w_planet_prop_dagobah.alo', 'w_planet_prop_dathomir.alo', 'w_planet_prop_desert.alo', 'w_planet_prop_desert01.alo', 'w_planet_prop_desert02.alo', 'w_planet_prop_desert03.alo', 'w_planet_prop_desert04.alo', 'w_planet_prop_dqar.alo', 'w_planet_prop_eadu.alo', 'w_planet_prop_endor.alo', 'w_planet_prop_eriadu.alo', 'w_planet_prop_eriadu01.alo', 'w_planet_prop_exogol.alo', 'w_planet_prop_felucia.alo', 'w_planet_prop_florrum.alo', 'w_planet_prop_forest.alo', 'w_planet_prop_forest01.alo', 'w_planet_prop_forest02.alo', 'w_planet_prop_forest03.alo', 'w_planet_prop_forest04.alo', 'w_planet_prop_geonosis.alo', 'w_planet_prop_geonosis_rings.alo', 'w_planet_prop_ice.alo', 'w_planet_prop_ice01.alo', 'w_planet_prop_ice02.alo', 'w_planet_prop_ice03.alo', 'w_planet_prop_ilum.alo', 'w_planet_prop_jakku.alo', 'w_planet_prop_jedha.alo', 'w_planet_prop_kamino.alo', 'w_planet_prop_kessel.alo', 'w_planet_prop_kuat.alo', 'w_planet_prop_lahmu.alo', 'w_planet_prop_lehon.alo', 'w_planet_prop_mandalore.alo', 'w_planet_prop_moon.alo', 'w_planet_prop_mustafar.alo', 'w_planet_prop_mustafar_blue.alo', 'w_planet_prop_mygeeto.alo', 'w_planet_prop_najedha.alo', 'w_planet_prop_nallhutta.alo', 'w_planet_prop_ocean.alo', 'w_planet_prop_ocean01.alo', 'w_planet_prop_ocean02.alo', 'w_planet_prop_ocean03.alo', 'w_planet_prop_ralltiir.alo', 'w_planet_prop_rattatak.alo', 'w_planet_prop_raxus.alo', 'w_planet_prop_ringovinda.alo', 'w_planet_prop_saleucami.alo', 'w_planet_prop_savareen.alo', 'w_planet_prop_scarif.alo', 'w_planet_prop_serenno.alo', 'w_planet_prop_starkillerbase.alo', 'w_planet_prop_sullust.alo', 'w_planet_prop_swamp.alo', 'w_planet_prop_swamp01.alo', 'w_planet_prop_swamp02.alo', 'w_planet_prop_swamp03.alo', 'w_planet_prop_taris.alo', 'w_planet_prop_taris01.alo', 'w_planet_prop_taspir.alo', 'w_planet_prop_tatooine.alo', 'w_planet_prop_telos.alo', 'w_planet_prop_temperate.alo', 'w_planet_prop_temperate01.alo', 'w_planet_prop_temperate02.alo', 'w_planet_prop_temperate03.alo', 'w_planet_prop_temperate04.alo', 'w_planet_prop_teth.alo', 'w_planet_prop_umbara.alo', 'w_planet_prop_utapau.alo', 'w_planet_prop_vulcanic.alo', 'w_planet_prop_vulpter.alo', 'w_planet_prop_wayland.alo', 'w_planet_prop_zakuul.alo', 'w_planet_prop_zygerria.alo', 'w_planet_ringo.alo', 'w_planet_saleucami.alo', 'w_planet_swamp.alo', 'w_planet_taris1.alo', 'w_planet_taris2.alo', 'w_planet_tatooine.alo', 'w_planet_temperate.alo', 'w_planet_vardos.alo', 'w_planet_vulcanic1.alo', 'w_planet_vulcanic2.alo', 'w_planet_wayland.alo']
p_planet_atmosphere_red.alo	Mod	['w_planet_gas_red.alo', 'w_planet_prop_gas_red.alo', 'w_planet_prop_yavin4.alo', 'w_planet_yavin.alo', 'w_planet_yavin_iv.alo']
p_planet_atmosphere_silver.alo	Mod	['w_planet_gas_blue.alo', 'w_planet_gas_silver.alo', 'w_planet_prop_gas_blue.alo', 'w_planet_prop_gas_silver.alo']
p_planet_atmosphere_yellow.alo	Mod	['w_planet_bespin.alo', 'w_planet_gas.alo', 'w_planet_gas_green.alo', 'w_planet_prop_bespin.alo', 'w_planet_prop_gas.alo', 'w_planet_prop_gas_green.alo']
p_planet_coruscant_atmosphere.alo	Unused?	[]
p_projectile_shield_blast.alo	Unused?	[]
p_redglow.alo	Unused?	[]
p_red_flash2.alo	Unused?	[]
p_red_rings3.alo	Unused?	[]
p_rocket_glow_generic.alo	Mod	['w_concussion_missile_ground_generic_white.alo']
p_rocket_green.alo	Mod	['Projectiles.xml']
p_rocket_motor.alo	Mod	['w_land_rocket.alo']
p_shield_blast_large00.alo	Mod	['Particles.xml']
p_ship_fire.alo	Mod	['empire_dominator_star_destroyer.alo']
p_ship_fire_explosion.alo	Mod	['empire_dominator_star_destroyer.alo', 'empire_shieldgate_lvl1.alo', 'empire_shieldgate_lvl2.alo', 'empire_shieldgate_lvl3.alo', 'empire_shieldgate_lvl4.alo', 'empire_shieldgate_lvl5.alo']
p_ship_fire_huge.alo	Unused?	[]
p_ship_fire_large.alo	Unused?	[]
p_ship_fire_small.alo	Unused?	[]
p_ship_fire_small_explosion.alo	Mod	['empire_dominator_star_destroyer.alo', 'empire_immobilizer_418.alo', 'empire_shieldgate_lvl1.alo', 'empire_shieldgate_lvl2.alo', 'empire_shieldgate_lvl3.alo', 'empire_shieldgate_lvl4.alo', 'empire_shieldgate_lvl5.alo', 'empire_vindicator.alo']
p_ship_fire_very_large.alo	Unused?	[]
p_ship_fire_very_small.alo	Unused?	[]
p_ship_fire_very_small_explosion.alo	Mod	['empire_dominator_star_destroyer.alo', 'empire_immobilizer_418.alo', 'empire_shieldgate_lvl1.alo', 'empire_shieldgate_lvl2.alo', 'empire_shieldgate_lvl3.alo', 'empire_shieldgate_lvl4.alo', 'empire_shieldgate_lvl5.alo', 'empire_vindicator.alo']
p_small_arms_red_ground_muzzle.alo	Unused?	[]
p_starforge.alo	Mod	['starforge.alo']
p_sulfur.alo	Mod	['w_planet_lolasayu.alo']
p_turbolaser_b.alo	Unused?	[]
p_turbolaser_b2.alo	Unused?	[]
p_turbolaser_g.alo	Unused?	[]
p_turbolaser_g2.alo	Unused?	[]
p_turbolaser_green.alo	Unused?	[]
p_turbolaser_r.alo	Unused?	[]
p_turbolaser_r2.alo	Unused?	[]
p_turbolaser_y.alo	Unused?	[]
p_weapon_chargedr.alo	Mod	['re_raddus.alo', 'rvre_raddus.alo', 'rv_mc112.alo']
p_weapon_chargedrgr.alo	Unused?	[]
p_weapon_charged_mass.alo	Unused?	[]
p_weapon_c_blinkblue.alo	Mod	['ev_acclamator_assault_ship.alo']
raddus_star_cruiser.alo	Unused?	[]
raider_corvette.alo	Unused?	[]
rebel_guard_trooper.alo	Mod	['Units_land_Rebel_Guard_Trooper.xml']
rebel_mon_calamari_mediator.alo	Unused?	[]
rebel_starbase_level_01.alo	Mod	['Starbases.xml']
rebel_starbase_level_02.alo	Mod	['Starbases.xml']
rebel_starbase_level_03.alo	Mod	['Starbases.xml']
rebel_starbase_level_04.alo	Mod	['Starbases.xml']
rebel_starbase_level_05.alo	Mod	['Starbases.xml']
reb_a_wing.alo	Mod	['Units_space_rebel_A-Wing.xml']
reb_b_wing.alo	Mod	['Units_space_rebel_bwing.xml']
reb_pelta_carrier.alo	Mod	['Units_Space_Republic_Pelta_Frigate.xml']
reb_pelta_carrier_d.alo	Unused?	[]
reb_quasar_sato.alo	Unused?	[]
reb_quasar_sato_d.alo	Unused?	[]
reb_x_wing.alo	Mod	['Units_hero_rebel_rogue_squadron.xml', 'units_space_rebel_x-wing.xml']
reb_y_wing.alo	Mod	['Units_space_rebel_Y-Wing.xml']
recusant.alo	Mod	['Units_Space_Confederacy_Recusant.xml']
reef_home-class_mc80_star_cruiser.alo	Unused?	[]
rejuvenatorsd.alo	Unused?	[]
rejuvenatorsd_d.alo	Unused?	[]
release_the_fury.alo	Mod	['Units_Space_Neutral_Release_the_Fury.xml']
rep_arctrooper_p2.alo	Mod	['Units_land_Mandalorian_Arc_Commando.xml']
rep_arctrooper_p2_v2.alo	Unused?	[]
rep_at_te.alo	Mod	['Units_land_Black_Sun_at_te.xml', 'units_land_hutts_at_te.xml', 'units_land_hutts_at_te.xml', 'units_land_hutts_at_te.xml', 'units_land_hutts_at_te.xml', 'units_land_hutts_at_te.xml', 'units_land_hutts_at_te.xml', 'units_land_hutts_at_te.xml', 'units_land_hutts_at_te.xml']
rep_at_te_turretbackleft.alo	Mod	['Hardpoints_AT_TE.xml']
rep_at_te_turretbackright.alo	Mod	['Hardpoints_AT_TE.xml']
rep_at_te_turretfrontbottomleft.alo	Mod	['Hardpoints_AT_TE.xml']
rep_at_te_turretfrontbottomright.alo	Mod	['Hardpoints_AT_TE.xml']
rep_at_te_turretfronttopleft.alo	Mod	['Hardpoints_AT_TE.xml']
rep_at_te_turretfronttopright.alo	Mod	['Hardpoints_AT_TE.xml']
rep_at_te_turrettopgun.alo	Mod	['Hardpoints_AT_TE.xml']
rep_clonetrooper_p2_501st.alo	Unused?	[]
rep_clonetrooper_p2_basic.alo	Unused?	[]
rep_i_phase2_arc_fives.alo	Unused?	[]
rep_light_cruiser.alo	Unused?	[]
rep_light_cruiser_d.alo	Unused?	[]
rep_light_cruiser_turret01.alo	Unused?	[]
rep_light_cruiser_turret02.alo	Unused?	[]
rep_light_cruiser_turret03.alo	Unused?	[]
rep_light_cruiser_turret04.alo	Unused?	[]
rep_pelta.alo	Mod	['Units_Space_Republic_Pelta_Frigate.xml']
rep_pelta_d.alo	Unused?	[]
rep_phase2_cgi-clone.alo	Unused?	[]
rep_starbase_hp01_comm.alo	Mod	['Hardpoints.xml']
rep_starbase_hp03_cm.alo	Mod	['Hardpoints.xml']
rep_starbase_hp03_ic.alo	Mod	['Hardpoints.xml']
rep_starbase_hp03_tbl.alo	Mod	['Hardpoints.xml']
rep_starbase_hp03_trp.alo	Mod	['Hardpoints.xml']
rep_starbase_hp04_tbl_01.alo	Mod	['Hardpoints.xml']
rep_starbase_hp04_tbl_02.alo	Mod	['Hardpoints.xml']
rep_starbase_hp05_tbl.alo	Mod	['Hardpoints.xml']
rep_starbase_hp05_trp.alo	Mod	['Hardpoints.xml']
rep_starbase_level_01.alo	Unused?	[]
rep_starbase_level_01_d.alo	Unused?	[]
rep_starbase_level_02.alo	Unused?	[]
rep_starbase_level_02_d.alo	Unused?	[]
rep_starbase_level_03.alo	Unused?	[]
rep_starbase_level_03_d.alo	Unused?	[]
rep_starbase_level_04.alo	Unused?	[]
rep_starbase_level_04_d.alo	Unused?	[]
rep_starbase_level_05.alo	Unused?	[]
rep_starbase_level_05_d.alo	Unused?	[]
rev_atpt.alo	Unused?	[]
rev_mandator.alo	Unused?	[]
rev_mandator_d.alo	Unused?	[]
re_raddus.alo	Unused?	[]
ri_cassian_andor.alo	Mod	['Units_hero_rebel_cassian_andor.xml']
ri_chewbacca.alo	Mod	['Namedherounits.xml']
ri_commando.alo	Mod	['Units_Land_Rebel_Commando.xml']
ri_commndo_v2.alo	Unused?	[]
ri_fieldcommander.alo	Mod	['Genericherounits.xml']
ri_grenadier.alo	Mod	['Units_land_Rebel_Grenadier.xml']
ri_grenadier_v2.alo	Unused?	[]
ri_hansolo.alo	Mod	['Namedherounits.xml']
ri_hero_x2.alo	Mod	['Units_land_Rebel_Elite_Soldier.xml']
ri_infantry2.alo	Unused?	[]
ri_infantry_desert2.alo	Unused?	[]
ri_infantry_snow2.alo	Unused?	[]
ri_jyn_erso.alo	Mod	['Units_hero_rebel_jyn_erso.xml']
ri_light_elite.alo	Unused?	[]
ri_light_elite_v2.alo	Unused?	[]
ri_newrinfantryplex_desert.alo	Mod	['Units_land_Crimson_Dawn_Sand_Plex_Trooper.xml']
ri_newrinfantryplex_forest.alo	Unused?	[]
ri_newrinfantryplex_snow.alo	Unused?	[]
ri_newrinfantryplex_urban.alo	Mod	['Units_land_Rebel_Plex_Soldier.xml']
ri_old_rex.alo	Unused?	[]
ri_rebel_jedi_ahsoka_tano.alo	Mod	['Units_hero_rebel_Ahsoka_Tano.xml']
ri_rebel_sniper_forest.alo	Mod	['Units_land_Rebel_Sniper_Forest.xml']
ri_rebel_sniper_snow.alo	Mod	['Units_land_Rebel_Sniper_Snow.xml']
ri_rebel_sniper_urban.alo	Mod	['Units_land_Empire_Deathtroopers.xml', 'units_land_rebel_sniper.xml', 'units_land_rebel_sniper.xml']
ri_saber_spin_kanan.alo	Unused?	[]
ri_saboteur.alo	Mod	['Units_land_Rebel_Saboteur.xml']
ri_skywalker.alo	Mod	['Units_hero_rebel_lukeskywalker.xml']
ri_stormtrooper.alo	Mod	['Units_Land_Rebel_RiflemanV2.xml']
ri_stormtrooper_v3.alo	Mod	['Units_Land_Rebel_Rifleman.xml']
ri_trooper_forest_human.alo	Mod	['Units_land_Rebel_Foresttrooper.xml']
ri_trooper_forest_human2.alo	Unused?	[]
ri_trooper_forest_human3.alo	Unused?	[]
ri_trooper_forest_twilek.alo	Mod	['Units_land_Black_Sun_Twilek_Forest.xml']
ri_trooper_plex_forest.alo	Mod	['Units_land_Rebel_Forest_PlexSoldier.xml']
ri_trooper_plex_sand.alo	Mod	['Units_land_Crimson_Dawn_Sand_Plex_Trooper.xml', 'units_land_hutts_sand_plex_trooper.xml', 'units_land_hutts_sand_plex_trooper.xml', 'units_land_hutts_sand_plex_trooper.xml', 'units_land_hutts_sand_plex_trooper.xml', 'units_land_hutts_sand_plex_trooper.xml', 'units_land_hutts_sand_plex_trooper.xml', 'units_land_hutts_sand_plex_trooper.xml', 'units_land_hutts_sand_plex_trooper.xml', 'units_land_hutts_sand_plex_trooper.xml', 'units_land_rebel_desert_plexsoldier.xml']
ri_trooper_plex_snow.alo	Mod	['Units_land_Rebel_Snow_PlexSoldier.xml']
ri_trooper_plex_urban.alo	Mod	['Units_land_Rebel_Plex_Soldier.xml', 'units_land_rebel_urban_plex_soldier.xml', 'units_land_rebel_urban_plex_soldier.xml']
ri_trooper_sand_human.alo	Mod	['Units_land_Rebel_Deserttrooper.xml']
ri_trooper_sand_human2.alo	Unused?	[]
ri_trooper_sand_human3.alo	Mod	['Units_land_Black_Sun_Sand_Trooper.xml', 'units_land_hutts_sand_trooper.xml', 'units_land_hutts_sand_trooper.xml', 'units_land_hutts_sand_trooper.xml', 'units_land_hutts_sand_trooper.xml', 'units_land_hutts_sand_trooper.xml', 'units_land_hutts_sand_trooper.xml', 'units_land_hutts_sand_trooper.xml', 'units_land_hutts_sand_trooper.xml', 'units_land_hutts_sand_trooper.xml']
ri_trooper_sand_twilek.alo	Mod	['Units_land_Black_Sun_Twilek_Sand.xml']
ri_trooper_snow_human.alo	Mod	['Units_land_Rebel_Snowtrooper.xml']
ri_trooper_snow_human2.alo	Unused?	[]
ri_trooper_snow_human3.alo	Unused?	[]
ri_trooper_snow_twilek.alo	Mod	['Units_land_Black_Sun_Twilek_Snow.xml']
ri_trooper_urban_aqualish.alo	Mod	['Units_land_Black_Sun_Aqualish_Bounty.xml', 'units_land_hutts_aqualish_bounty.xml', 'units_land_hutts_aqualish_bounty.xml', 'units_land_hutts_aqualish_bounty.xml', 'units_land_hutts_aqualish_bounty.xml', 'units_land_hutts_aqualish_bounty.xml', 'units_land_hutts_aqualish_bounty.xml', 'units_land_hutts_aqualish_bounty.xml', 'units_land_hutts_aqualish_bounty.xml', 'units_land_hutts_aqualish_bounty.xml']
ri_trooper_urban_female2.alo	Mod	['Units_land_rebel_Rebel_Vanguard_Trooper.xml']
ri_trooper_urban_human.alo	Mod	['Units_land_Rebel_Rebel_Trooper.xml', 'units_land_rebel_urban_trooper.xml', 'units_land_rebel_urban_trooper.xml']
ri_trooper_urban_human2.alo	Unused?	[]
ri_trooper_urban_human3.alo	Unused?	[]
ri_trooper_urban_quarren.alo	Mod	['Units_land_Hutts_Quarren_Bounty.xml']
ri_trooper_urban_quarren3.alo	Mod	['Units_land_Hutts_Quarren_Bounty3.xml']
ri_trooper_urban_rodian.alo	Mod	['Units_land_Black_Sun_Rodian_Bounty.xml', 'units_hero_hutt_cartel_greedo.xml', 'units_hero_hutt_cartel_greedo.xml']
ri_trooper_urban_rodian3.alo	Mod	['Units_land_Black_Sun_Rodian_Bounty2.xml', 'units_land_crimson_dawn_rodian_bounty2.xml', 'units_land_crimson_dawn_rodian_bounty2.xml', 'units_land_crimson_dawn_rodian_bounty2.xml', 'units_land_crimson_dawn_rodian_bounty2.xml', 'units_land_crimson_dawn_rodian_bounty2.xml', 'units_land_crimson_dawn_rodian_bounty2.xml', 'units_land_crimson_dawn_rodian_bounty2.xml', 'units_land_crimson_dawn_rodian_bounty2.xml', 'units_land_crimson_dawn_rodian_bounty2.xml', 'units_land_hutts_rodian_bounty2.xml', 'units_land_hutts_rodian_bounty2.xml', 'units_land_hutts_rodian_bounty2.xml', 'units_land_hutts_rodian_bounty2.xml', 'units_land_hutts_rodian_bounty2.xml', 'units_land_hutts_rodian_bounty2.xml', 'units_land_hutts_rodian_bounty2.xml', 'units_land_hutts_rodian_bounty2.xml', 'units_land_hutts_rodian_bounty2.xml']
ri_trooper_urban_twilek.alo	Mod	['Units_land_Black_Sun_Twilek_Trooper.xml', 'units_land_crimson_dawn_twilek_trooper.xml', 'units_land_crimson_dawn_twilek_trooper.xml', 'units_land_crimson_dawn_twilek_trooper.xml', 'units_land_crimson_dawn_twilek_trooper.xml', 'units_land_crimson_dawn_twilek_trooper.xml', 'units_land_crimson_dawn_twilek_trooper.xml', 'units_land_crimson_dawn_twilek_trooper.xml', 'units_land_crimson_dawn_twilek_trooper.xml', 'units_land_crimson_dawn_twilek_trooper.xml', 'units_land_hutts_twilek_trooper.xml', 'units_land_hutts_twilek_trooper.xml', 'units_land_hutts_twilek_trooper.xml', 'units_land_hutts_twilek_trooper.xml', 'units_land_hutts_twilek_trooper.xml', 'units_land_hutts_twilek_trooper.xml', 'units_land_hutts_twilek_trooper.xml', 'units_land_hutts_twilek_trooper.xml', 'units_land_hutts_twilek_trooper.xml']
ri_vanguard_urban.alo	Unused?	[]
ri_wookieplex.alo	Unused?	[]
rvre_raddus.alo	Unused?	[]
rvre_starhawk.alo	Unused?	[]
rvre_starhawk_d.alo	Unused?	[]
rvre_starhawk_turret_01.alo	Unused?	[]
rvre_starhawk_turret_02.alo	Unused?	[]
rvre_starhawk_turret_03.alo	Unused?	[]
rvre_starhawk_turret_04.alo	Unused?	[]
rvre_starhawk_turret_05.alo	Unused?	[]
rvre_starhawk_turret_06.alo	Unused?	[]
rvre_starhawk_turret_07.alo	Unused?	[]
rvre_starhawk_turret_08.alo	Unused?	[]
rvre_starhawk_turret_09.alo	Unused?	[]
rvre_starhawk_turret_10.alo	Unused?	[]
rvre_vigil.alo	Unused?	[]
rvre_vigil_d.alo	Unused?	[]
rv_aac2.alo	Unused?	[]
rv_aac2_d.alo	Unused?	[]
rv_aac3.alo	Unused?	[]
rv_aac3_turret.alo	Mod	['Hardpoints.xml']
rv_aac_hovertank.alo	Unused?	[]
rv_assault_frigatemkiiix.alo	Unused?	[]
rv_atrt.alo	Unused?	[]
rv_attack_tank.alo	Unused?	[]
rv_attack_tank_d.alo	Unused?	[]
rv_attack_tank_turret_01.alo	Mod	['HardPoints_Attack_Tank.xml']
rv_attack_tank_turret_02.alo	Mod	['HardPoints_Attack_Tank.xml']
rv_attack_tank_turret_03.alo	Mod	['HardPoints_Attack_Tank.xml']
rv_home_one.alo	Unused?	[]
rv_lusankya.alo	Mod	['Units_hero_rebel_Lusankya.xml']
rv_mandator.alo	Unused?	[]
rv_mc108.alo	Unused?	[]
rv_mc108_d.alo	Unused?	[]
rv_mc112.alo	Unused?	[]
rv_mc112_d.alo	Unused?	[]
rv_mc80.alo	Unused?	[]
rv_mc80ajm.alo	Unused?	[]
rv_mc80ajm_d.alo	Unused?	[]
rv_mc80wl.alo	Unused?	[]
rv_mc85.alo	Unused?	[]
rv_mc85_d.alo	Unused?	[]
rv_mediator.alo	Unused?	[]
rv_mediator_battlecruiser.alo	Unused?	[]
rv_mediator_cruiser_d.alo	Unused?	[]
rv_mediator_d.alo	Unused?	[]
rv_moncalcruiser.alo	Mod	['Units_Space_Rebel_mc80_Liberty.xml']
rv_mon_cal80.alo	Unused?	[]
rv_quasar_sato.alo	Unused?	[]
rv_quasar_sato_d.alo	Unused?	[]
rv_salvator.alo	Mod	['Units_hero_rebel_Salvator.xml']
rv_snowspeeder.alo	Vanilla	[]
rv_t12b.alo	Unused?	[]
rv_t12b_d.alo	Unused?	[]
rv_t12b_turret.alo	Mod	['Hardpoints.xml']
rv_t12b_turret2.alo	Mod	['Hardpoints.xml']
rv_t12b_turret3.alo	Mod	['Hardpoints.xml']
rv_t12b_turret4.alo	Mod	['Hardpoints.xml']
rv_t12b_turret5.alo	Mod	['Hardpoints.xml']
rv_t12b_turret6.alo	Mod	['Hardpoints.xml']
rv_t1bx.alo	Mod	['Units_land_rebel_t1b_tank.xml']
rv_t2b-aav.alo	Unused?	[]
rv_t2b-aav_d.alo	Unused?	[]
rv_t3bx.alo	Unused?	[]
rv_t4_b.alo	Unused?	[]
rv_t4_b_00.alo	Unused?	[]
rv_t5bx.alo	Unused?	[]
rv_t5bx_d.alo	Unused?	[]
rv_t6bx.alo	Unused?	[]
rv_t6bxx.alo	Unused?	[]
rv_t6bx_d.alo	Unused?	[]
rv_t8bx.alo	Unused?	[]
rv_t8bx_back_turret.alo	Unused?	[]
rv_t8bx_d.alo	Unused?	[]
rv_tb10.alo	Unused?	[]
rv_tb10_d.alo	Unused?	[]
rv_tb10_turret_l.alo	Unused?	[]
rv_tb10_turret_r.alo	Unused?	[]
rv_uwing.alo	Mod	['Units_space_rebel_u_wing.xml']
rv_uwing_blue.alo	Mod	['Units_space_rebel_u_wing.xml']
rv_uwing_landing.alo	Mod	['Units_space_rebel_u_wing.xml']
rv_v19_landspeeder.alo	Unused?	[]
rv_viscount_class_star_defender.alo	Mod	['Units_Space_Rebel_Viscount.xml']
s-1_firehawke_heavy_repulsortank.alo	Unused?	[]
s-1_firehawke_heavy_repulsortank_b.alo	Mod	['Hardpoints_Heavy_Repulsortank.xml']
s-1_firehawke_heavy_repulsortank_hatch.alo	Mod	['Hardpoints_Heavy_Repulsortank.xml']
s-1_firehawke_heavy_repulsortank_hatch_open.alo	Unused?	[]
s-1_firehawke_heavy_repulsortank_rb.alo	Unused?	[]
salvator_d.alo	Mod	['Units_hero_rebel_Salvator.xml']
secutor_star_destroyer.alo	Unused?	[]
sev_carrier.alo	Mod	['Units_space_Confederacy_carrier.xml']
sev_droid_bomber.alo	Mod	['Units_space_Confederacy_droidbomber.xml']
sev_tridroid.alo	Mod	['Units_space_cis_tridroid.xml']
sev_vulture.alo	Mod	['Units_space_cis_vulture.xml']
sphaerolana.alo	Unused?	[]
sphaerolana_defender.alo	Unused?	[]
ss_quasarfire.alo	Unused?	[]
st.alo	Unused?	[]
starforge.alo	Unused?	[]
starforge_d.alo	Unused?	[]
starforge_prop.alo	Unused?	[]
starforge_star.alo	Unused?	[]
starkiller_base_high.alo	Unused?	[]
starkiller_base_low.alo	Unused?	[]
star_destroyer_prototype.alo	Unused?	[]
star_destroyer_turret_00.alo	Unused?	[]
station.alo	Unused?	[]
strident_gold_star_destroyer.alo	Unused?	[]
strident_star_destroyer.alo	Unused?	[]
tector_star_destroyer.alo	Mod	['Units_Space_Empire_Tector.xml']
titan_star_destroyer.alo	Unused?	[]
trooper_transport.alo	Unused?	[]
turbulent_star_destroyer.alo	Unused?	[]
ui_falleen_assassin.alo	Unused?	[]
ui_gamorrean.alo	Mod	['Units_land_Hutts_Gamorrean.xml']
uv_eclipse.alo	Vanilla	[]
uv_eclipse_d.alo	Unused?	[]
uv_interceptoriv.alo	Vanilla	[]
uv_interceptoriv_cine.alo	Unused?	[]
uv_interceptoriv_d.alo	Vanilla	[]
uv_interceptoriv_hp00_b-l.alo	Mod	['Hardpoints_underworld.xml']
uv_interceptoriv_hp00_b-r.alo	Mod	['Hardpoints_underworld.xml']
uv_interceptoriv_hp00_f.alo	Mod	['Hardpoints_underworld.xml']
uv_invencible.alo	Unused?	[]
uv_invencible_d.alo	Unused?	[]
uv_kedalbebattleship.alo	Vanilla	[]
uv_nebulon_c.alo	Unused?	[]
uv_nebulon_c_d.alo	Unused?	[]
v-wing.alo	Mod	['Units_space_Black_Sun_V_Wing.xml', 'units_space_hutt_v_wing.xml']
venator-class_star_destroyer.alo	Unused?	[]
venator_star_destroyer.alo	Mod	['Units_space_Black_Sun_venator.xml', 'units_space_hutt_cartel_venator.xml', 'units_space_hutt_cartel_venator.xml', 'units_space_empire_venator.xml', 'units_space_empire_venator.xml']
vengeance.alo	Mod	['Units_hero_empire_Vengeance.xml']
victoryii.alo	Mod	['Units_space_empire_VictoryII.xml']
victoryiii.alo	Mod	['Units_space_empire_VictoryIII.xml']
vindicator.alo	Unused?	[]
vindicator_sd.alo	Unused?	[]
viscount.alo	Unused?	[]
viscount_d.alo	Mod	['Units_Space_Rebel_Viscount.xml']
wrath_of_war.alo	Mod	['Units_Space_Neutral_Wrath_of_War.xml']
w_acc_missile.alo	Mod	['Projectiles.xml']
w_adumarplanet .alo	Unused?	[]
w_adv_concussion_missiletie95gr.alo	Mod	['Projectiles.xml']
w_bimmisaariplanet.alo	Unused?	[]
w_black_hole.alo	Mod	['Spaceprops.xml']
w_black_hole_small.alo	Mod	['Planets.xml']
w_charubahplanet.alo	Unused?	[]
w_commenorplanet.alo	Unused?	[]
w_concussion_missile.alo	Mod	['Projectiles.xml', 'projectiles_land.xml']
w_concussion_missile_4c.alo	Unused?	[]
w_concussion_missile_ground_generic_white.alo	Mod	['Projectiles_Land.xml']
w_dolomarplanet.alo	Unused?	[]
w_flack_podb.alo	Mod	['Projectiles.xml']
w_flack_podb2.alo	Mod	['Projectiles.xml']
w_flack_podx.alo	Mod	['Projectiles.xml']
w_flakm_proyectile.alo	Unused?	[]
w_galaxy00.alo	Mod	['Planets.xml']
w_gc_planet_alderaan.alo	Unused?	[]
w_gc_planet_bespin.alo	Unused?	[]
w_gc_planet_forest.alo	Unused?	[]
w_gc_planet_ice.alo	Unused?	[]
w_gc_planet_logo.alo	Mod	['Planets.xml']
w_gc_planet_swamp.alo	Unused?	[]
w_gc_planet_taris.alo	Unused?	[]
w_gc_planet_temperate.alo	Unused?	[]
w_gc_planet_vulcanic.alo	Unused?	[]
w_gc_planet_wayland.alo	Unused?	[]
w_gc_planet_yaviniv.alo	Unused?	[]
w_gc_sith_planet_logo.alo	Mod	['Planets.xml']
w_greenlaser_largehvyx.alo	Mod	['Projectiles.xml']
w_kuat_ring_new_part02.alo	Unused?	[]
w_kuat_ring_new_part02_d.alo	Unused?	[]
w_kuat_ring_new_part03.alo	Unused?	[]
w_kuat_ring_new_part03_d.alo	Unused?	[]
w_kuat_ring_new_part04.alo	Unused?	[]
w_kuat_ring_new_part04_d.alo	Unused?	[]
w_kuat_ring_new_part05.alo	Unused?	[]
w_kuat_ring_new_part05_d.alo	Unused?	[]
w_kuat_ring_new_part06.alo	Unused?	[]
w_kuat_ring_new_part06_d.alo	Unused?	[]
w_kuat_ring_new_part07.alo	Unused?	[]
w_kuat_ring_new_part07_d.alo	Unused?	[]
w_land_flak_missile.alo	Unused?	[]
w_land_rocket.alo	Mod	['Projectiles.xml']
w_laserhvyredlandx.alo	Mod	['Projectiles.xml']
w_laserhvyredlandxf.alo	Mod	['Projectiles.xml']
w_lasert1bredlandx.alo	Mod	['Projectiles.xml']
w_laser_eweb_green.alo	Mod	['Projectiles.xml']
w_laser_eweb_red.alo	Mod	['Projectiles.xml']
w_laser_g.alo	Unused?	[]
w_laser_g2.alo	Mod	['Projectiles.xml']
w_laser_g4.alo	Unused?	[]
w_laser_hand_blue.alo	Mod	['Projectiles.xml']
w_laser_invisible.alo	Mod	['Containers.xml', 'layerzdummy.xml', 'layerzdummy.xml', 'projectiles.xml', 'projectiles.xml', 'projectiles.xml', 'projectiles.xml', 'projectiles.xml', 'projectiles.xml', 'projectiles.xml', 'projectiles.xml', 'projectiles.xml', 'projectiles.xml', 'projectiles.xml', 'projectiles.xml', 'projectiles.xml', 'projectiles.xml', 'projectiles.xml', 'projectiles.xml', 'projectiles.xml', 'projectiles.xml', 'projectiles.xml', 'projectiles.xml', 'projectiles.xml', 'projectiles_land.xml']
w_laser_small.alo	Mod	['Projectiles.xml']
w_laser_smallb.alo	Unused?	[]
w_laser_smally.alo	Mod	['Projectiles.xml']
w_levianplanet.alo	Unused?	[]
w_mc80mmissile.alo	Mod	['Projectiles.xml']
w_nebula_maw2.alo	Unused?	[]
w_particle_blue.alo	Mod	['Particles.xml']
w_particle_green.alo	Mod	['Particles.xml']
w_particle_red.alo	Mod	['Particles.xml']
w_particle_yellow.alo	Mod	['Particles.xml']
w_pedistal_faction.alo	Mod	['Markers.xml']
w_pedistal_faction_1.alo	Mod	['Markers.xml']
w_pedistal_faction_10.alo	Mod	['Markers.xml']
w_pedistal_faction_2.alo	Mod	['Markers.xml']
w_pedistal_faction_3.alo	Mod	['Markers.xml']
w_pedistal_faction_4.alo	Mod	['Markers.xml']
w_pedistal_faction_5.alo	Mod	['Markers.xml']
w_planet_alderaan.alo	Unused?	[]
w_planet_antar_high.alo	Unused?	[]
w_planet_antar_low.alo	Unused?	[]
w_planet_bespin.alo	Unused?	[]
w_planet_cato_neimodia.alo	Unused?	[]
w_planet_christophis.alo	Unused?	[]
w_planet_coruscant1.alo	Unused?	[]
w_planet_coruscant2.alo	Unused?	[]
w_planet_dathomir_cw.alo	Unused?	[]
w_planet_datomir.alo	Unused?	[]
w_planet_deathstar.alo	Mod	['Markers.xml', 'spaceprops.xml', 'spaceunitssupers.xml', 'spaceunitssupers.xml']
w_planet_desert.alo	Unused?	[]
w_planet_endor.alo	Unused?	[]
w_planet_eriadu.alo	Unused?	[]
w_planet_florrum.alo	Unused?	[]
w_planet_foerost_high.alo	Unused?	[]
w_planet_foerost_low.alo	Unused?	[]
w_planet_forest.alo	Unused?	[]
w_planet_fresia_high.alo	Unused?	[]
w_planet_fresia_low.alo	Unused?	[]
w_planet_gas.alo	Unused?	[]
w_planet_gas_blue.alo	Unused?	[]
w_planet_gas_green.alo	Unused?	[]
w_planet_gas_red.alo	Unused?	[]
w_planet_gas_silver.alo	Vanilla	[]
w_planet_geonosis.alo	Unused?	[]
w_planet_ice.alo	Unused?	[]
w_planet_kamino.alo	Unused?	[]
w_planet_kashyyyk_high.alo	Unused?	[]
w_planet_kashyyyk_low.alo	Unused?	[]
w_planet_korriban01.alo	Vanilla	[]
w_planet_kuat.alo	Unused?	[]
w_planet_kuat_low.alo	Vanilla	[]
w_planet_lolasayu.alo	Unused?	[]
w_planet_lolasayu_noparticle.alo	Unused?	[]
w_planet_mechis_high.alo	Unused?	[]
w_planet_mechis_low.alo	Unused?	[]
w_planet_moon.alo	Unused?	[]
w_planet_mustafar1.alo	Unused?	[]
w_planet_mustafar2.alo	Unused?	[]
w_planet_mustafar_blue.alo	Unused?	[]
w_planet_ocean.alo	Unused?	[]
w_planet_prop_aargau.alo	Mod	['Spaceprops.xml']
w_planet_prop_achto.alo	Mod	['Spaceprops.xml']
w_planet_prop_aeten.alo	Mod	['Spaceprops.xml']
w_planet_prop_alderaan.alo	Mod	['Spaceprops.xml']
w_planet_prop_anaxes.alo	Mod	['Spaceprops.xml']
w_planet_prop_anoat.alo	Mod	['Spaceprops.xml']
w_planet_prop_axxila.alo	Mod	['Spaceprops.xml']
w_planet_prop_belkadan.alo	Mod	['Spaceprops.xml']
w_planet_prop_bespin.alo	Mod	['Spaceprops.xml']
w_planet_prop_byss.alo	Mod	['Spaceprops.xml']
w_planet_prop_christophsis.alo	Mod	['Spaceprops.xml']
w_planet_prop_coruscant.alo	Mod	['Spaceprops.xml']
w_planet_prop_crait.alo	Mod	['Spaceprops.xml']
w_planet_prop_dagobah.alo	Mod	['Spaceprops.xml']
w_planet_prop_dathomir.alo	Mod	['Spaceprops.xml']
w_planet_prop_desert.alo	Mod	['Spaceprops.xml']
w_planet_prop_desert01.alo	Mod	['Spaceprops.xml']
w_planet_prop_desert02.alo	Mod	['Spaceprops.xml']
w_planet_prop_desert03.alo	Mod	['Spaceprops.xml']
w_planet_prop_desert04.alo	Mod	['Spaceprops.xml']
w_planet_prop_dqar.alo	Mod	['Spaceprops.xml']
w_planet_prop_eadu.alo	Mod	['Spaceprops.xml']
w_planet_prop_endor.alo	Mod	['Spaceprops.xml']
w_planet_prop_eriadu.alo	Mod	['Spaceprops.xml']
w_planet_prop_eriadu01.alo	Mod	['Spaceprops.xml']
w_planet_prop_exogol.alo	Mod	['Spaceprops.xml']
w_planet_prop_felucia.alo	Mod	['Spaceprops.xml']
w_planet_prop_florrum.alo	Mod	['Spaceprops.xml']
w_planet_prop_fondor.alo	Mod	['Spaceprops.xml']
w_planet_prop_forest.alo	Mod	['Spaceprops.xml']
w_planet_prop_forest01.alo	Mod	['Spaceprops.xml']
w_planet_prop_forest02.alo	Mod	['Spaceprops.xml']
w_planet_prop_forest03.alo	Mod	['Spaceprops.xml']
w_planet_prop_forest04.alo	Mod	['Spaceprops.xml']
w_planet_prop_gas.alo	Mod	['Spaceprops.xml']
w_planet_prop_gas_blue.alo	Mod	['Spaceprops.xml']
w_planet_prop_gas_green.alo	Mod	['Spaceprops.xml']
w_planet_prop_gas_red.alo	Mod	['Spaceprops.xml']
w_planet_prop_gas_silver.alo	Mod	['Spaceprops.xml']
w_planet_prop_geonosis.alo	Mod	['Spaceprops.xml']
w_planet_prop_geonosis_rings.alo	Mod	['Spaceprops.xml']
w_planet_prop_hosnianprime.alo	Mod	['Spaceprops.xml']
w_planet_prop_ice.alo	Mod	['Spaceprops.xml']
w_planet_prop_ice01.alo	Mod	['Spaceprops.xml']
w_planet_prop_ice02.alo	Mod	['Spaceprops.xml']
w_planet_prop_ice03.alo	Mod	['Spaceprops.xml']
w_planet_prop_ilum.alo	Mod	['Spaceprops.xml']
w_planet_prop_jakku.alo	Mod	['Spaceprops.xml']
w_planet_prop_jedha.alo	Mod	['Spaceprops.xml']
w_planet_prop_kamino.alo	Mod	['Spaceprops.xml']
w_planet_prop_kessel.alo	Mod	['Spaceprops.xml']
w_planet_prop_korriban.alo	Mod	['Spaceprops.xml']
w_planet_prop_kuat.alo	Mod	['Spaceprops.xml']
w_planet_prop_lahmu.alo	Mod	['Spaceprops.xml']
w_planet_prop_lehon.alo	Mod	['Spaceprops.xml']
w_planet_prop_mandalore.alo	Mod	['Spaceprops.xml']
w_planet_prop_moon.alo	Mod	['Spaceprops.xml']
w_planet_prop_mustafar.alo	Mod	['Spaceprops.xml']
w_planet_prop_mustafar_blue.alo	Mod	['Spaceprops.xml']
w_planet_prop_mygeeto.alo	Mod	['Spaceprops.xml']
w_planet_prop_najedha.alo	Mod	['Spaceprops.xml']
w_planet_prop_nallhutta.alo	Mod	['Spaceprops.xml']
w_planet_prop_ocean.alo	Mod	['Spaceprops.xml']
w_planet_prop_ocean01.alo	Mod	['Spaceprops.xml']
w_planet_prop_ocean02.alo	Mod	['Spaceprops.xml']
w_planet_prop_ocean03.alo	Mod	['Spaceprops.xml']
w_planet_prop_ralltiir.alo	Mod	['Spaceprops.xml']
w_planet_prop_rattatak.alo	Mod	['Spaceprops.xml']
w_planet_prop_raxus.alo	Mod	['Spaceprops.xml']
w_planet_prop_ringovinda.alo	Mod	['Spaceprops.xml']
w_planet_prop_saleucami.alo	Mod	['Spaceprops.xml']
w_planet_prop_savareen.alo	Mod	['Spaceprops.xml']
w_planet_prop_scarif.alo	Mod	['Spaceprops.xml']
w_planet_prop_serenno.alo	Mod	['Spaceprops.xml']
w_planet_prop_starkillerbase.alo	Mod	['Spaceprops.xml']
w_planet_prop_sullust.alo	Mod	['Spaceprops.xml']
w_planet_prop_swamp.alo	Mod	['Spaceprops.xml']
w_planet_prop_swamp01.alo	Mod	['Spaceprops.xml']
w_planet_prop_swamp02.alo	Mod	['Spaceprops.xml']
w_planet_prop_swamp03.alo	Mod	['Spaceprops.xml']
w_planet_prop_taris.alo	Mod	['Spaceprops.xml']
w_planet_prop_taris01.alo	Unused?	[]
w_planet_prop_taspir.alo	Mod	['Spaceprops.xml']
w_planet_prop_tatooine.alo	Mod	['Spaceprops.xml']
w_planet_prop_telos.alo	Mod	['Spaceprops.xml']
w_planet_prop_temperate.alo	Mod	['Spaceprops.xml']
w_planet_prop_temperate01.alo	Mod	['Spaceprops.xml']
w_planet_prop_temperate02.alo	Mod	['Spaceprops.xml']
w_planet_prop_temperate03.alo	Mod	['Spaceprops.xml']
w_planet_prop_temperate04.alo	Mod	['Spaceprops.xml']
w_planet_prop_teth.alo	Mod	['Spaceprops.xml']
w_planet_prop_umbara.alo	Mod	['Spaceprops.xml']
w_planet_prop_urban.alo	Mod	['Spaceprops.xml']
w_planet_prop_utapau.alo	Mod	['Spaceprops.xml']
w_planet_prop_vardos.alo	Mod	['Spaceprops.xml']
w_planet_prop_vulcanic.alo	Mod	['Spaceprops.xml']
w_planet_prop_vulcanic01.alo	Mod	['Spaceprops.xml']
w_planet_prop_vulpter.alo	Mod	['Spaceprops.xml']
w_planet_prop_wayland.alo	Mod	['Spaceprops.xml']
w_planet_prop_yavin4.alo	Mod	['Spaceprops.xml']
w_planet_prop_zakuul.alo	Mod	['Spaceprops.xml']
w_planet_prop_zygerria.alo	Mod	['Spaceprops.xml']
w_planet_rattatak1.alo	Unused?	[]
w_planet_rattatak_high.alo	Unused?	[]
w_planet_rattatak_low.alo	Unused?	[]
w_planet_raxus_prime.alo	Unused?	[]
w_planet_rendilli.alo	Unused?	[]
w_planet_ringo.alo	Unused?	[]
w_planet_ringovinda_low.alo	Unused?	[]
w_planet_saleucami.alo	Unused?	[]
w_planet_scarif.alo	Unused?	[]
w_planet_skako.alo	Unused?	[]
w_planet_sluisvan_high.alo	Unused?	[]
w_planet_sluisvan_low.alo	Unused?	[]
w_planet_sphere_aargau.alo	Mod	['Planets.xml']
w_planet_sphere_achcto.alo	Mod	['Planets.xml']
w_planet_sphere_aeten.alo	Mod	['Planets.xml']
w_planet_sphere_alarisprime.alo	Mod	['Planets.xml']
w_planet_sphere_alderaan.alo	Mod	['Planets.xml']
w_planet_sphere_anaxes.alo	Mod	['Planets.xml']
w_planet_sphere_anoat.alo	Mod	['Planets.xml']
w_planet_sphere_axxila.alo	Mod	['Planets.xml']
w_planet_sphere_belkadan.alo	Mod	['Planets.xml']
w_planet_sphere_bespin.alo	Mod	['Planets.xml']
w_planet_sphere_byss.alo	Mod	['Planets.xml']
w_planet_sphere_christophsis.alo	Mod	['Planets.xml']
w_planet_sphere_coruscant.alo	Mod	['Planets.xml']
w_planet_sphere_coruscant01.alo	Unused?	[]
w_planet_sphere_crait.alo	Mod	['Planets.xml']
w_planet_sphere_dagobah.alo	Mod	['Planets.xml']
w_planet_sphere_dathomir.alo	Mod	['Planets.xml']
w_planet_sphere_desert.alo	Mod	['Planets.xml']
w_planet_sphere_desert01.alo	Mod	['Planets.xml']
w_planet_sphere_desert02.alo	Mod	['Planets.xml']
w_planet_sphere_desert03.alo	Mod	['Planets.xml']
w_planet_sphere_desert04.alo	Mod	['Planets.xml']
w_planet_sphere_dqar.alo	Mod	['Planets.xml']
w_planet_sphere_eadu.alo	Mod	['Planets.xml']
w_planet_sphere_endor.alo	Unused?	[]
w_planet_sphere_endor_system.alo	Mod	['Planets.xml']
w_planet_sphere_eriadu.alo	Mod	['Planets.xml']
w_planet_sphere_eriadu01.alo	Mod	['Planets.xml']
w_planet_sphere_exogol.alo	Mod	['Planets.xml']
w_planet_sphere_felucia.alo	Mod	['Planets.xml']
w_planet_sphere_florrum.alo	Mod	['Planets.xml']
w_planet_sphere_fondor.alo	Mod	['Planets.xml']
w_planet_sphere_forest.alo	Mod	['Planets.xml']
w_planet_sphere_forest01.alo	Mod	['Planets.xml']
w_planet_sphere_forest02.alo	Mod	['Planets.xml']
w_planet_sphere_forest03.alo	Mod	['Planets.xml']
w_planet_sphere_forest04.alo	Mod	['Planets.xml']
w_planet_sphere_gas.alo	Mod	['Planets.xml']
w_planet_sphere_gas_blue.alo	Unused?	[]
w_planet_sphere_gas_green.alo	Unused?	[]
w_planet_sphere_gas_red.alo	Mod	['Planets.xml']
w_planet_sphere_gas_silver.alo	Unused?	[]
w_planet_sphere_geonosis.alo	Mod	['Planets.xml']
w_planet_sphere_geonosis_rings.alo	Mod	['Planets.xml']
w_planet_sphere_hosnianprime.alo	Mod	['Planets.xml']
w_planet_sphere_ice.alo	Mod	['Planets.xml']
w_planet_sphere_ice01.alo	Mod	['Planets.xml']
w_planet_sphere_ice02.alo	Mod	['Planets.xml']
w_planet_sphere_ice03.alo	Mod	['Planets.xml']
w_planet_sphere_ilum.alo	Mod	['Planets.xml']
w_planet_sphere_jakku.alo	Mod	['Planets.xml']
w_planet_sphere_jedha.alo	Unused?	[]
w_planet_sphere_jedha_system.alo	Mod	['Planets.xml']
w_planet_sphere_kamino.alo	Mod	['Planets.xml']
w_planet_sphere_kessel.alo	Mod	['Planets.xml']
w_planet_sphere_korriban.alo	Mod	['Planets.xml']
w_planet_sphere_kuat.alo	Mod	['Planets.xml']
w_planet_sphere_lahmu.alo	Mod	['Planets.xml']
w_planet_sphere_lehon.alo	Mod	['Planets.xml']
w_planet_sphere_mandalore.alo	Mod	['Planets.xml']
w_planet_sphere_moon.alo	Unused?	[]
w_planet_sphere_mustafar.alo	Unused?	[]
w_planet_sphere_mustafar_blue.alo	Unused?	[]
w_planet_sphere_mygeeto.alo	Mod	['Planets.xml']
w_planet_sphere_najedha.alo	Unused?	[]
w_planet_sphere_nallhutta.alo	Mod	['Planets.xml']
w_planet_sphere_ocean.alo	Mod	['Planets.xml']
w_planet_sphere_ocean01.alo	Mod	['Planets.xml']
w_planet_sphere_ocean02.alo	Mod	['Planets.xml']
w_planet_sphere_ocean03.alo	Mod	['Planets.xml']
w_planet_sphere_prop_alderaan.alo	Mod	['Spaceprops.xml']
w_planet_sphere_prop_bespin.alo	Mod	['Spaceprops.xml']
w_planet_sphere_prop_concord.alo	Mod	['Spaceprops.xml']
w_planet_sphere_prop_coruscant.alo	Mod	['Spaceprops.xml']
w_planet_sphere_prop_desert.alo	Unused?	[]
w_planet_sphere_prop_endor.alo	Mod	['Spaceprops.xml']
w_planet_sphere_prop_eraidu.alo	Unused?	[]
w_planet_sphere_prop_forest.alo	Unused?	[]
w_planet_sphere_prop_gas.alo	Unused?	[]
w_planet_sphere_prop_gas_green.alo	Mod	['Spaceprops.xml']
w_planet_sphere_prop_gas_red.alo	Unused?	[]
w_planet_sphere_prop_gas_silver.alo	Unused?	[]
w_planet_sphere_prop_geonosis.alo	Unused?	[]
w_planet_sphere_prop_ice.alo	Unused?	[]
w_planet_sphere_prop_jedha.alo	Mod	['Spaceprops.xml']
w_planet_sphere_prop_kamino.alo	Unused?	[]
w_planet_sphere_prop_moon.alo	Unused?	[]
w_planet_sphere_prop_mustafar.alo	Mod	['Spaceprops.xml']
w_planet_sphere_prop_mustafar_blue.alo	Unused?	[]
w_planet_sphere_prop_narrshaddaa.alo	Mod	['Spaceprops.xml']
w_planet_sphere_prop_ocean.alo	Unused?	[]
w_planet_sphere_prop_saleucami.alo	Unused?	[]
w_planet_sphere_prop_swamp.alo	Unused?	[]
w_planet_sphere_prop_taris.alo	Unused?	[]
w_planet_sphere_prop_tatooine.alo	Unused?	[]
w_planet_sphere_prop_temperate.alo	Unused?	[]
w_planet_sphere_prop_vulcanic.alo	Unused?	[]
w_planet_sphere_prop_wayland.alo	Unused?	[]
w_planet_sphere_prop_yavin_iv.alo	Mod	['Spaceprops.xml']
w_planet_sphere_ralltiir.alo	Mod	['Planets.xml']
w_planet_sphere_rattatak.alo	Mod	['Planets.xml']
w_planet_sphere_raxus.alo	Mod	['Planets.xml']
w_planet_sphere_ringovinda.alo	Mod	['Planets.xml']
w_planet_sphere_rishi.alo	Mod	['Planets.xml']
w_planet_sphere_saleucami.alo	Mod	['Planets.xml']
w_planet_sphere_savareen.alo	Mod	['Planets.xml']
w_planet_sphere_scarif.alo	Mod	['Planets.xml']
w_planet_sphere_serenno.alo	Mod	['Planets.xml']
w_planet_sphere_starkillerbase.alo	Mod	['Planets.xml', 'spaceprops.xml']
w_planet_sphere_sullust.alo	Mod	['Planets.xml']
w_planet_sphere_swamp.alo	Mod	['Planets.xml']
w_planet_sphere_swamp01.alo	Mod	['Planets.xml']
w_planet_sphere_swamp02.alo	Mod	['Planets.xml']
w_planet_sphere_swamp03.alo	Mod	['Planets.xml']
w_planet_sphere_taris.alo	Mod	['Planets.xml']
w_planet_sphere_taspir.alo	Mod	['Planets.xml']
w_planet_sphere_tatooine.alo	Mod	['Planets.xml']
w_planet_sphere_telos.alo	Mod	['Planets.xml']
w_planet_sphere_temperate.alo	Mod	['Planets.xml']
w_planet_sphere_temperate01.alo	Mod	['Planets.xml']
w_planet_sphere_temperate02.alo	Mod	['Planets.xml']
w_planet_sphere_temperate03.alo	Mod	['Planets.xml']
w_planet_sphere_temperate04.alo	Mod	['Planets.xml']
w_planet_sphere_teth.alo	Mod	['Planets.xml']
w_planet_sphere_umbara.alo	Mod	['Planets.xml']
w_planet_sphere_urban.alo	Mod	['Planets.xml']
w_planet_sphere_utapau.alo	Mod	['Planets.xml']
w_planet_sphere_vardos.alo	Mod	['Planets.xml']
w_planet_sphere_vulcanic.alo	Mod	['Planets.xml']
w_planet_sphere_vulcanic01.alo	Mod	['Planets.xml']
w_planet_sphere_vulcanic_system.alo	Mod	['Planets.xml']
w_planet_sphere_vulpter.alo	Mod	['Planets.xml']
w_planet_sphere_wayland.alo	Mod	['Planets.xml']
w_planet_sphere_yavin.alo	Unused?	[]
w_planet_sphere_yavin4.alo	Unused?	[]
w_planet_sphere_yavin_system.alo	Mod	['Planets.xml']
w_planet_sphere_zakuul.alo	Mod	['Planets.xml']
w_planet_sphere_zygerria.alo	Mod	['Planets.xml']
w_planet_swamp.alo	Unused?	[]
w_planet_taris1.alo	Unused?	[]
w_planet_taris2.alo	Unused?	[]
w_planet_tatooine.alo	Unused?	[]
w_planet_temperate.alo	Unused?	[]
w_planet_the_wheel_high.alo	Unused?	[]
w_planet_the_wheel_low.alo	Unused?	[]
w_planet_umbara.alo	Unused?	[]
w_planet_vardos.alo	Unused?	[]
w_planet_vardos_high.alo	Unused?	[]
w_planet_vulcanic1.alo	Unused?	[]
w_planet_vulcanic2.alo	Unused?	[]
w_planet_wayland.alo	Unused?	[]
w_planet_yavin.alo	Unused?	[]
w_planet_yavin_iv.alo	Unused?	[]
w_projectile_assault_missile.alo	Mod	['Projectiles.xml']
w_projectile_concussion_missile_b.alo	Mod	['Projectiles.xml', 'projectiles_land.xml', 'projectiles_land.xml', 'projectiles_space.xml']
w_prop_kiros_square.alo	Unused?	[]
w_prop_kiros_statue.alo	Unused?	[]
w_protontorp.alo	Mod	['Projectiles.xml']
w_proton_torpedo.alo	Mod	['Projectiles.xml']
w_redlaser_largehvyx.alo	Unused?	[]
w_skydome_nebula_blue.alo	Mod	['Spacesecondaryskydomes.xml']
w_skydome_nebula_brown.alo	Mod	['Spacesecondaryskydomes.xml']
w_skydome_nebula_purple.alo	Mod	['Spacesecondaryskydomes.xml']
w_solo_maw_backdrop.alo	Unused?	[]
w_solo_maw_backdrop_sec.alo	Unused?	[]
w_stars_low_maw.alo	Unused?	[]
w_stars_maw_solo.alo	Unused?	[]
w_stars_maw_solo_sec.alo	Unused?	[]
w_stars_nebulae_02.alo	Unused?	[]
w_stars_nebula_purple02.alo	Vanilla	[]
w_super_heavy_turbolaser_b_front.alo	Mod	['Projectiles_Space.xml']
w_super_heavy_turbolaser_g_front.alo	Mod	['Projectiles_Space.xml']
w_turbolaser_blue1.alo	Mod	['Projectiles_Space.xml']
w_turbolaser_blue2.alo	Mod	['Projectiles_Space.xml']
w_turbolaser_blue3.alo	Mod	['Projectiles_Space.xml']
w_turbolaser_green1.alo	Mod	['Projectiles_Space.xml']
w_turbolaser_green2.alo	Mod	['Projectiles_Space.xml']
w_turbolaser_green3.alo	Mod	['Projectiles_Space.xml']
w_turbolaser_green4.alo	Mod	['Projectiles_Space.xml']
w_turbolaser_green6.alo	Mod	['Projectiles_Space.xml']
w_turbolaser_green8.alo	Mod	['Projectiles_Space.xml']
w_turbolaser_green_bombardment.alo	Mod	['Projectiles.xml']
w_turbolaser_red1.alo	Mod	['Projectiles_Space.xml']
w_turbolaser_red2.alo	Mod	['Projectiles_Space.xml']
w_turbolaser_red3.alo	Mod	['Projectiles_Space.xml']
w_turbolaser_red4.alo	Mod	['Projectiles_Space.xml']
w_turbolaser_red6.alo	Mod	['Projectiles_Space.xml']
w_turbolaser_red8.alo	Mod	['Projectiles_Space.xml']
w_turbolaser_red_bombardment.alo	Mod	['Projectiles.xml']
w_turbolaser_y1.alo	Mod	['Projectiles_Space.xml']
w_turbolaser_y2.alo	Mod	['Projectiles.xml', 'projectiles_space.xml']
w_universe_skydome01.alo	Mod	['Spaceprimaryskydomes.xml']
w_universe_skydome02.alo	Mod	['Spaceprimaryskydomes.xml']
w_universe_skydome03.alo	Mod	['Spaceprimaryskydomes.xml']
w_universe_skydome04.alo	Mod	['Spaceprimaryskydomes.xml']
w_universe_skydome05.alo	Mod	['Spaceprimaryskydomes.xml']
w_universe_skydomebackup.alo	Unused?	[]
xyston_destroyer.alo	Mod	['Units_space_empire_Xyston.xml']
xyston_destroyerii.alo	Mod	['Units_space_empire_XystonII.xml']
w_planet_fleet.alo	Missing	['Containers.xml']
rv_ywing.alo	Missing	['Containers.xml', 'groundvehicles.xml', 'units_space_rebel_y-wing.xml', 'units_space_rebel_y-wing.xml']
w_waypoint_beacon.alo	Missing	['Gameconstants.xml']
rb_acc_l01.alo	Missing	['Groundbases.xml']
rb_acc_l02.alo	Missing	['Groundbases.xml']
rb_acc_l03.alo	Missing	['Groundbases.xml']
rb_acc_l04.alo	Missing	['Groundbases.xml']
rb_acc_l05.alo	Missing	['Groundbases.xml']
nb_basepad_imperial.alo	Missing	['GroundbuildablesCIS.xml']
nb_repairfacility.alo	Missing	['GroundbuildablesCIS.xml', 'groundturrets.xml']
nb_bactatank.alo	Missing	['GroundbuildablesCIS.xml', 'groundturrets.xml']
nb_basepad.alo	Missing	['Groundbuildablesskirmish.xml']
rb_shield-generator.alo	Missing	['Groundbuildablesskirmish.xml', 'markers.xml', 'specialstructures.xml', 'specialstructures.xml', 'specialstructures_empire.xml']
nb_baseshieldgen.alo	Missing	['Groundbuildablesskirmish.xml', 'markers.xml', 'specialstructures_black_sun.xml', 'specialstructures_cis.xml', 'specialstructures_empire.xml', 'specialstructures_hutt_cartel.xml', 'specialstructures_rebel.xml']
nb_baseshieldgen_small.alo	Missing	['Groundbuildablesskirmish.xml', 'markers.xml', 'specialstructures.xml', 'specialstructures.xml', 'specialstructures.xml', 'specialstructures_black_sun.xml', 'specialstructures_cis.xml', 'specialstructures_empire.xml', 'specialstructures_hutt_cartel.xml']
nb_cmc22mining.alo	Missing	['Groundbuildablesskirmish.xml', 'specialstructures_black_sun.xml', 'specialstructures_cis.xml', 'specialstructures_empire.xml', 'specialstructures_hutt_cartel.xml', 'specialstructures_rebel.xml', 'specialstructures_underworld.xml']
eb_tltower.alo	Missing	['Groundbuildablesskirmish.xml', 'markers.xml', 'markers.xml', 'secondarystructures.xml', 'specialstructures.xml', 'specialstructures.xml']
eb_infantrybarracks.alo	Missing	['Groundbuildablesskirmish.xml', 'specialstructures_empire.xml']
rb_infantrybarracks.alo	Missing	['Groundbuildablesskirmish.xml', 'specialstructures_rebel.xml']
eb_lightfactory.alo	Missing	['Groundbuildablesskirmish.xml', 'specialstructures_empire.xml']
rb_lightvehiclefactory.alo	Missing	['Groundbuildablesskirmish.xml', 'specialstructures_cis.xml', 'specialstructures_rebel.xml']
eb_vehiclefactory.alo	Missing	['Groundbuildablesskirmish.xml', 'markers.xml', 'secondarystructures.xml', 'specialstructures_empire.xml']
rb_heavyvehiclefactory.alo	Missing	['Groundbuildablesskirmish.xml', 'markers.xml', 'secondarystructures.xml', 'specialstructures_rebel.xml']
eb_megaadvancedweapons.alo	Missing	['Groundbuildablesskirmish.xml', 'markers.xml', 'specialstructures_empire.xml']
eb_officeracademy.alo	Missing	['Groundbuildablesskirmish.xml', 'props_story.xml', 'specialstructures_empire.xml']
rb_officeracademy.alo	Missing	['Groundbuildablesskirmish.xml', 'specialstructures_rebel.xml']
eb_researchfacility.alo	Missing	['Groundbuildablesskirmish.xml', 'specialstructures_empire.xml']
rb_researchfacility.alo	Missing	['Groundbuildablesskirmish.xml', 'specialstructures_rebel.xml']
rb_comcenter.alo	Missing	['Groundbuildablesskirmish.xml', 'specialstructures.xml', 'specialstructures.xml']
eb_commandcenter.alo	Missing	['Groundbuildablesskirmish.xml', 'specialstructures_empire.xml']
rb_commandcenter.alo	Missing	['Groundbuildablesskirmish.xml', 'specialstructures_rebel.xml']
w_pedistal.alo	Missing	['Groundbuildablesskirmish.xml', 'markers.xml', 'markers.xml', 'markers.xml']
nb_cmc22mining_sml.alo	Missing	['Groundbuildablesskirmish.xml', 'specialstructures.xml']
ni_gmale_swamp_a.alo	Missing	['Groundindigenous.xml', 'groundinfantry.xml']
ni_ewok.alo	Missing	['Groundindigenous.xml']
ni_ewok_b.alo	Missing	['Groundindigenous.xml', 'props_story.xml']
ni_ewok_c.alo	Missing	['Groundindigenous.xml', 'props_story.xml']
ni_gmale_desert_a.alo	Missing	['Groundindigenous.xml', 'props_story.xml']
ni_gmale_urban_a.alo	Missing	['Groundindigenous.xml', 'groundinfantry.xml']
ni_gmale_swamp_b.alo	Missing	['Groundindigenous.xml']
ni_gmale_swamp_c.alo	Missing	['Groundindigenous.xml']
ni_gmale_urban_b.alo	Missing	['Groundindigenous.xml']
ni_gmale_urban_c.alo	Missing	['Groundindigenous.xml']
ni_gmale_snow.alo	Missing	['Groundindigenous.xml']
ni_gungan.alo	Missing	['Groundindigenous.xml']
ni_moncalciv.alo	Missing	['Groundindigenous.xml']
ri_wookiee_unarmed.alo	Missing	['Groundindigenous.xml']
ri_wookiee01.alo	Missing	['Groundindigenous.xml', 'props_story.xml']
ni_jawa.alo	Missing	['Groundindigenous.xml', 'props_story.xml']
ni_sandpeople_b.alo	Missing	['Groundindigenous.xml', 'props_story.xml']
ni_sandpeople_c.alo	Missing	['Groundindigenous.xml']
ni_bothan.alo	Missing	['Groundindigenous.xml']
ri_infantry.alo	Missing	['Groundindigenous.xml', 'groundinfantry.xml', 'groundinfantry.xml', 'props_story.xml', 'units_land_crimson_dawn_rodian_bounty2.xml', 'units_land_crimson_dawn_rodian_bounty2.xml', 'units_land_crimson_dawn_twilek_trooper.xml', 'units_land_crimson_dawn_twilek_trooper.xml', 'units_land_rebel_rebel_trooper.xml', 'units_land_rebel_rebel_trooper.xml', 'units_land_rebel_rebel_trooper.xml']
ei_royalgaurd.alo	Missing	['Groundindigenous.xml', 'groundinfantry.xml']
ni_hutt.alo	Missing	['Groundindigenous.xml']
ni_twilek_f.alo	Missing	['Groundindigenous.xml']
ni_geonosian.alo	Missing	['Groundindigenous.xml']
ni_sullustan.alo	Missing	['Groundindigenous.xml']
ni_nightsister_ranger.alo	Missing	['Groundindigenous.xml']
ni_noghri.alo	Missing	['Groundindigenous.xml']
ni_mustafarian.alo	Missing	['Groundindigenous.xml']
ni_mandalorian.alo	Missing	['Groundindigenous.xml']
wc_bantha.alo	Missing	['Groundindigenous.xml', 'props_story.xml']
ai_wampa.alo	Missing	['Groundindigenous.xml', 'props_story.xml']
ai_sarlacc.alo	Missing	['Groundindigenous.xml', 'props_story.xml']
ai_rancor.alo	Missing	['Groundindigenous.xml', 'props_story.xml']
w_bird.alo	Missing	['Groundindigenous.xml']
w_bird_medium.alo	Missing	['Groundindigenous.xml']
w_bird_light.alo	Missing	['Groundindigenous.xml', 'props_story.xml']
ai_sketto.alo	Missing	['Groundindigenous.xml']
w_dustdevil.alo	Missing	['Groundindigenous.xml']
w_bugs.alo	Missing	['Groundindigenous.xml']
ai_womprat.alo	Missing	['Groundindigenous.xml', 'props_story.xml']
ai_tauntaun.alo	Missing	['Groundindigenous.xml', 'props_story.xml']
ai_shaaks.alo	Missing	['Groundindigenous.xml', 'props_story.xml']
ai_groundbeetle.alo	Missing	['Groundindigenous.xml', 'props_story.xml']
w_felucia_plant_01.alo	Missing	['Groundindigenous.xml', 'props_story.xml']
w_felucia_plant_purple.alo	Missing	['Groundindigenous.xml']
w_felucia_plantbig_purple.alo	Missing	['Groundindigenous.xml']
w_felucia_bulbplant.alo	Missing	['Groundindigenous.xml']
ai_airwhale.alo	Missing	['Groundindigenous.xml']
ai_dactillion.alo	Missing	['Groundindigenous.xml']
w_flag_marker.alo	Missing	['Groundinfantry.xml']
ri_pilot.alo	Missing	['Groundinfantry.xml']
ri_infiltrator.alo	Missing	['Groundinfantry.xml']
ni_piratesoldier.alo	Missing	['Groundinfantry.xml']
ni_pirateplex.alo	Missing	['Groundinfantry.xml']
w_disruptor_death.alo	Missing	['Groundinfantry.xml']
w_infect.alo	Missing	['Groundinfantry.xml']
eb_aaturret.alo	Missing	['Groundturrets.xml', 'props_story.xml']
rb_aa-turret.alo	Missing	['Groundturrets.xml']
eb_infantryturret.alo	Missing	['Groundturrets.xml']
rb_turret.alo	Missing	['Groundturrets.xml']
eb_vehicleturret.alo	Missing	['Groundturrets.xml']
rb_vehicleturret.alo	Missing	['Groundturrets.xml']
nv_pskiff.alo	Missing	['Groundvehicles.xml']
nv_pskiff_imperial.alo	Missing	['Groundvehicles.xml']
nv_pskiff_rebel.alo	Missing	['Groundvehicles.xml']
nv_pskiff_chew.alo	Missing	['Groundvehicles.xml']
p_smoke_small02.alo	Missing	['Groundvehicles.xml', 'particles.xml']
rv_transport.alo	Missing	['Groundvehicles.xml', 'transportunits.xml', 'transportunits.xml']
w_bespin_collector_droid.alo	Missing	['Groundvehicles.xml']
empire_imperial_star_destroyer_dual_turbolaser_25.alo	Missing	['Hardpoints.xml']
empire_imperial_star_destroyer_dual_turbolaser_26.alo	Missing	['Hardpoints.xml']
empire_imperial_star_destroyer_dual_turbolaser_27.alo	Missing	['Hardpoints.xml']
ev_stardestroyer_hp00_l-f.alo	Missing	['Hardpoints.xml', 'spaceprops.xml']
ev_stardestroyer_hp00_f-r.alo	Missing	['Hardpoints.xml', 'spaceprops.xml']
ev_stardestroyer_hp00_b-l.alo	Missing	['Hardpoints.xml', 'spaceprops.xml']
ev_stardestroyer_hp00_b-r.alo	Missing	['Hardpoints.xml', 'spaceprops.xml']
ev_stardestroyer_hp00_m-l.alo	Missing	['Hardpoints.xml']
ev_stardestroyer_hp00_m-r.alo	Missing	['Hardpoints.xml']
ev_stardestroyer_hp00_m-c.alo	Missing	['Hardpoints.xml', 'spaceprops.xml']
ev_stardestroyer_hp00_e.alo	Missing	['Hardpoints.xml']
rv_corvette_leia_hp00_e.alo	Missing	['Hardpoints.xml']
ev_interdictor_hp00_f-l.alo	Missing	['Hardpoints.xml', 'spaceprops.xml']
ev_interdictor_hp00_f-r.alo	Missing	['Hardpoints.xml', 'spaceprops.xml']
ev_interdictor_hp00_b-l.alo	Missing	['Hardpoints.xml', 'spaceprops.xml']
ev_interdictor_hp00_b-r.alo	Missing	['Hardpoints.xml', 'spaceprops.xml']
ev_interdictor_hp00_c-m.alo	Missing	['Hardpoints.xml']
ev_interdictor_hp00_c-b.alo	Missing	['Hardpoints.xml']
ev_interdictor_hp00_e.alo	Missing	['Hardpoints.xml']
rv_assaultfrigate_hp00_f-l.alo	Missing	['Hardpoints.xml', 'spaceprops.xml']
rv_assaultfrigate_hp00_f-r.alo	Missing	['Hardpoints.xml', 'spaceprops.xml']
rv_assaultfrigate_hp00_b-l.alo	Missing	['Hardpoints.xml', 'spaceprops.xml']
rv_assaultfrigate_hp00_b-r.alo	Missing	['Hardpoints.xml', 'spaceprops.xml']
rv_assaultfrigate_hp00_e.alo	Missing	['Hardpoints.xml']
rb_station_01_hp01_ccm.alo	Missing	['Hardpoints.xml']
rb_station_01_hp01_lc.alo	Missing	['Hardpoints.xml']
rb_station_01_hp01_tbl.alo	Missing	['Hardpoints.xml', 'spaceprops.xml']
rb_station_01_hp01_shg.alo	Missing	['Hardpoints.xml', 'spaceprops.xml']
rb_station_01_hp01_ca.alo	Missing	['Hardpoints.xml', 'spaceprops.xml']
rb_station_02_hp02_lc.alo	Missing	['Hardpoints.xml', 'spaceprops.xml']
rb_station_02_hp02_prt.alo	Missing	['Hardpoints.xml']
rb_station_02_hp02_tbl.alo	Missing	['Hardpoints.xml', 'spaceprops.xml']
rb_station_03_hp03_ccm.alo	Missing	['Hardpoints.xml']
rb_station_03_hp03_ic.alo	Missing	['Hardpoints.xml', 'spaceprops.xml']
rb_station_03_hp03_prt.alo	Missing	['Hardpoints.xml', 'spaceprops.xml']
rb_station_04_hp04_ic.alo	Missing	['Hardpoints.xml', 'spaceprops.xml']
rb_station_04_hp04_lc.alo	Missing	['Hardpoints.xml', 'spaceprops.xml']
rb_station_04_hp04_tbl.alo	Missing	['Hardpoints.xml', 'spaceprops.xml']
rb_station_04_hp04_shg.alo	Missing	['Hardpoints.xml', 'spaceprops.xml']
rb_station_05_hp05_ccm.alo	Missing	['Hardpoints.xml', 'spaceprops.xml']
rb_station_05_hp05_ic.alo	Missing	['Hardpoints.xml', 'spaceprops.xml']
rb_station_05_hp05_prt.alo	Missing	['Hardpoints.xml', 'spaceprops.xml']
rb_station_05_hp05_tbl.alo	Missing	['Hardpoints.xml', 'spaceprops.xml']
rb_station_05_hp05_tbl2.alo	Missing	['Hardpoints.xml', 'spaceprops.xml']
eb_station_01_hp01_cm.alo	Missing	['Hardpoints.xml', 'spaceprops.xml']
eb_station_01_hp01_lc.alo	Missing	['Hardpoints.xml', 'spaceprops.xml']
eb_station_01_hp01_tbl.alo	Missing	['Hardpoints.xml', 'spaceprops.xml']
eb_station_01_hp01_shg.alo	Missing	['Hardpoints.xml', 'spaceprops.xml']
eb_station_01_hp01_ca.alo	Missing	['Hardpoints.xml', 'spaceprops.xml']
eb_station_02_hp02_lc.alo	Missing	['Hardpoints.xml', 'spaceprops.xml']
eb_station_02_hp02_prt.alo	Missing	['Hardpoints.xml', 'spaceprops.xml']
eb_station_02_hp02_tbl.alo	Missing	['Hardpoints.xml', 'spaceprops.xml']
eb_station_03_hp03_cm.alo	Missing	['Hardpoints.xml', 'spaceprops.xml']
eb_station_03_hp03_ic.alo	Missing	['Hardpoints.xml', 'spaceprops.xml']
eb_station_03_hp03_prt.alo	Missing	['Hardpoints.xml', 'spaceprops.xml']
eb_station_04_hp04_ic.alo	Missing	['Hardpoints.xml', 'spaceprops.xml']
eb_station_04_hp04_lc.alo	Missing	['Hardpoints.xml']
eb_station_04_hp04_tbl.alo	Missing	['Hardpoints.xml', 'spaceprops.xml']
eb_station_05_hp05_cm.alo	Missing	['Hardpoints.xml', 'spaceprops.xml']
eb_station_05_hp05_ic.alo	Missing	['Hardpoints.xml', 'spaceprops.xml']
eb_station_05_hp05_prt.alo	Missing	['Hardpoints.xml', 'spaceprops.xml']
eb_station_05_hp05_tbl.alo	Missing	['Hardpoints.xml', 'spaceprops.xml']
rv_homeone_hp_shg.alo	Missing	['Hardpoints.xml', 'spaceprops.xml']
rv_homeone_hp_tbl_bl.alo	Missing	['Hardpoints.xml', 'spaceprops.xml']
rv_homeone_hp_tbl_br.alo	Missing	['Hardpoints.xml', 'spaceprops.xml']
rv_homeone_hp_tbl_fl.alo	Missing	['Hardpoints.xml', 'spaceprops.xml']
rv_homeone_hp_tbl_fr.alo	Missing	['Hardpoints.xml', 'spaceprops.xml']
rv_homeone_hp_ic_bl.alo	Missing	['Hardpoints.xml', 'spaceprops.xml']
rv_homeone_hp_ic_br.alo	Missing	['Hardpoints.xml', 'spaceprops.xml']
rv_homeone_hp_ic_fl.alo	Missing	['Hardpoints.xml', 'spaceprops.xml']
rv_homeone_hp_ic_fr.alo	Missing	['Hardpoints.xml', 'spaceprops.xml']
nv_jedicruiser_hp_b-m.alo	Missing	['Hardpoints.xml', 'spaceprops.xml']
nv_jedicruiser_hp_f-l.alo	Missing	['Hardpoints.xml', 'spaceprops.xml']
nv_jedicruiser_hp_f-r.alo	Missing	['Hardpoints.xml', 'spaceprops.xml']
nv_jedicruiser_hp_m-l.alo	Missing	['Hardpoints.xml']
nv_jedicruiser_hp_m-r.alo	Missing	['Hardpoints.xml']
nv_jedicruiser_hp_b-l.alo	Missing	['Hardpoints.xml']
nv_jedicruiser_hp_b-r.alo	Missing	['Hardpoints.xml']
nv_pirate_frigate_hp00_f.alo	Missing	['Hardpoints.xml', 'spaceprops.xml']
nv_pirate_frigate_hp00_b-l.alo	Missing	['Hardpoints.xml', 'spaceprops.xml']
nv_pirate_frigate_hp00_b-r.alo	Missing	['Hardpoints.xml', 'spaceprops.xml']
nb_apbase_hp_ll1.alo	Missing	['Hardpoints.xml', 'spaceprops.xml']
nb_apbase_hp_tl1.alo	Missing	['Hardpoints.xml', 'spaceprops.xml']
nb_apbase_hp_tl2.alo	Missing	['Hardpoints.xml', 'spaceprops.xml']
nb_apbase_hp_tl3.alo	Missing	['Hardpoints.xml', 'spaceprops.xml']
nb_apbase_hp_tl4.alo	Missing	['Hardpoints.xml', 'spaceprops.xml']
nb_apbase_hp_ht1.alo	Missing	['Hardpoints.xml', 'spaceprops.xml']
nb_apbase_hp_ht2.alo	Missing	['Hardpoints.xml', 'spaceprops.xml']
nb_apbase_hp_shg.alo	Missing	['Hardpoints.xml', 'spaceprops.xml']
nb_apbase_hp_hb.alo	Missing	['Hardpoints.xml', 'spaceprops.xml']
ev_executorstardestroyer_hp_l_trb00.alo	Missing	['Hardpoints_underworld.xml']
ev_executorstardestroyer_hp_l_trb01.alo	Missing	['Hardpoints_underworld.xml']
ev_executorstardestroyer_hp_l_trb02.alo	Missing	['Hardpoints_underworld.xml']
ev_executorstardestroyer_hp_l_trb03.alo	Missing	['Hardpoints_underworld.xml']
ev_executorstardestroyer_hp_l_trb04.alo	Missing	['Hardpoints_underworld.xml']
ev_executorstardestroyer_hp_l_ion00.alo	Missing	['Hardpoints_underworld.xml']
ev_executorstardestroyer_hp_l_ion01.alo	Missing	['Hardpoints_underworld.xml']
ev_executorstardestroyer_hp_l_ion02.alo	Missing	['Hardpoints_underworld.xml']
ev_executorstardestroyer_hp_l_conm00.alo	Missing	['Hardpoints_underworld.xml']
ev_executorstardestroyer_hp_l_conm01.alo	Missing	['Hardpoints_underworld.xml']
ev_executorstardestroyer_hp_l_torp.alo	Missing	['Hardpoints_underworld.xml']
ev_executorstardestroyer_hp_r_trb00.alo	Missing	['Hardpoints_underworld.xml']
ev_executorstardestroyer_hp_r_trb01.alo	Missing	['Hardpoints_underworld.xml']
ev_executorstardestroyer_hp_r_trb02.alo	Missing	['Hardpoints_underworld.xml']
ev_executorstardestroyer_hp_r_trb03.alo	Missing	['Hardpoints_underworld.xml']
ev_executorstardestroyer_hp_r_trb04.alo	Missing	['Hardpoints_underworld.xml']
ev_executorstardestroyer_hp_r_ion00.alo	Missing	['Hardpoints_underworld.xml']
ev_executorstardestroyer_hp_r_ion01.alo	Missing	['Hardpoints_underworld.xml']
ev_executorstardestroyer_hp_r_ion02.alo	Missing	['Hardpoints_underworld.xml']
ev_executorstardestroyer_hp_r_conm00.alo	Missing	['Hardpoints_underworld.xml']
ev_executorstardestroyer_hp_r_torp.alo	Missing	['Hardpoints_underworld.xml']
ev_executorstardestroyer_hp_m_torp.alo	Missing	['Hardpoints_underworld.xml']
ev_executorstardestroyer_hp_trac.alo	Missing	['Hardpoints_underworld.xml']
ev_executorstardestroyer_hp_shld00.alo	Missing	['Hardpoints_underworld.xml']
ev_executorstardestroyer_hp_shld01.alo	Missing	['Hardpoints_underworld.xml']
ev_executorstardestroyer_hp_shld02.alo	Missing	['Hardpoints_underworld.xml']
ev_executorstardestroyer_hp_e.alo	Missing	['Hardpoints_underworld.xml']
ev_executorstardestroyer_hp_e2.alo	Missing	['Hardpoints_underworld.xml']
uv_vengeance_hp_lft_mdc.alo	Missing	['Hardpoints_underworld.xml']
uv_vengeance_hp_rgt_mdc.alo	Missing	['Hardpoints_underworld.xml']
uv_vengeance_hp_lft_tb.alo	Missing	['Hardpoints_underworld.xml']
ev_archammer_hp_lc_l_00.alo	Missing	['Hardpoints_underworld.xml']
ev_archammer_hp_lc_r_00.alo	Missing	['Hardpoints_underworld.xml']
ub_01_station_hp01_com.alo	Missing	['Hardpoints_underworld.xml']
ub_01_station_hp01_shg.alo	Missing	['Hardpoints_underworld.xml']
ub_03_station_hp03_pt.alo	Missing	['Hardpoints_underworld.xml']
ub_03_station_hp03_gun.alo	Missing	['Hardpoints_underworld.xml']
ub_04_station_hp04_pc.alo	Missing	['Hardpoints_underworld.xml']
ub_05_station_hp05_ic.alo	Missing	['Hardpoints_underworld.xml']
ub_05_station_hp05_pt.alo	Missing	['Hardpoints_underworld.xml']
ub_05_station_hp05_tbl.alo	Missing	['Hardpoints_underworld.xml']
ub_palace_hp_gen.alo	Missing	['Hardpoints_underworld.xml']
ub_palace_hp_comm.alo	Missing	['Hardpoints_underworld.xml']
w_flag_marker_green.alo	Missing	['Markers.xml']
w_flag_marker_blue.alo	Missing	['Markers.xml']
eb_gravcontrolgen.alo	Missing	['Markers.xml', 'specialstructures.xml']
nb_piratebase_01.alo	Missing	['Markers.xml', 'specialstructures.xml', 'specialstructures_black_sun.xml']
nv_lrs.alo	Missing	['Markers.xml', 'specialstructures.xml', 'specialstructures.xml', 'specialstructures.xml', 'specialstructures.xml', 'specialstructures.xml']
rb_station_05.alo	Missing	['Markers.xml', 'starbases.xml']
w_flag_marker_white.alo	Missing	['Markers.xml', 'props_story.xml', 'props_story.xml', 'props_story.xml', 'props_story.xml', 'props_story.xml', 'props_story.xml', 'props_story.xml', 'props_story.xml', 'props_story.xml', 'props_story.xml']
w_flag_marker_yellow.alo	Missing	['Markers.xml']
w_flag_marker_red.alo	Missing	['Markers.xml']
w_pedistal_rebel.alo	Missing	['Markers.xml']
w_pedistal_imperial.alo	Missing	['Markers.xml', 'props_story.xml']
w_pedistal_underworld.alo	Missing	['Markers.xml']
w_flag_marker_purple.alo	Missing	['Markers.xml']
mdp_00.alo	Missing	['Mobile_defense_units.xml']
uv_mdu.alo	Missing	['Mobile_defense_units.xml']
ev_mdu.alo	Missing	['Mobile_defense_units.xml']
rv_mdu.alo	Missing	['Mobile_defense_units.xml']
ei_palpatine.alo	Missing	['Namedherounits.xml']
ei_marajade.alo	Missing	['Namedherounits.xml']
ri_obiwan.alo	Missing	['Namedherounits.xml']
ri_kylekatarn.alo	Missing	['Namedherounits.xml']
ri_r2.alo	Missing	['Namedherounits.xml']
ri_c3po.alo	Missing	['Namedherounits.xml']
p_damage_turbolaser_miss_vlarge_green_ultra.alo	Missing	['Particles.xml']
p_mouse_click.alo	Missing	['Particles.xml']
p_mouse_double_click.alo	Missing	['Particles.xml']
p_mouse_click_attack.alo	Missing	['Particles.xml']
p_mouse_guard.alo	Missing	['Particles.xml']
p_shield_penetration_generic.alo	Missing	['Particles.xml']
p_dirt_emitter_test1.alo	Missing	['Particles.xml']
p_lava_bubbles.alo	Missing	['Particles.xml']
p_hover_generic.alo	Missing	['Particles.xml']
p_steam_small01.alo	Missing	['Particles.xml']
p_explosion_small00.alo	Missing	['Particles.xml']
p_explosion_empire_small00.alo	Missing	['Particles.xml']
p_explosion_med00.alo	Missing	['Particles.xml']
p_explosion_empire_med00.alo	Missing	['Particles.xml']
p_explosion_big00.alo	Missing	['Particles.xml']
p_explosion_empire_big00.alo	Missing	['Particles.xml']
p_explosion_huge00.alo	Missing	['Particles.xml']
p_explosion_friggin_huge00.alo	Missing	['Particles.xml']
p_explosion_empire_friggin_huge00.alo	Missing	['Particles.xml']
p_explosion_empire_huge00.alo	Missing	['Particles.xml']
p_explosion_empire_huge00_no_debris.alo	Missing	['Particles.xml']
p_explosion_small01.alo	Missing	['Particles.xml']
p_explosion_missile_ground01.alo	Missing	['Particles.xml']
p_explosion_thermal_empire.alo	Missing	['Particles.xml']
p_explosion_thermal_underworld.alo	Missing	['Particles.xml']
p_explosion_thermal_rebel.alo	Missing	['Particles.xml']
p_seismic_explosion00.alo	Missing	['Particles.xml']
p_explosion_med01.alo	Missing	['Particles.xml']
p_explosion_big01.alo	Missing	['Particles.xml']
p_sab_bomb.alo	Missing	['Particles.xml']
p_ewok_suicide.alo	Missing	['Particles.xml']
p_explosion_atat01.alo	Missing	['Particles.xml']
p_explosion_huge01.alo	Missing	['Particles.xml']
p_damage_small00.alo	Missing	['Particles.xml']
p_damage_med00.alo	Missing	['Particles.xml']
p_damage_big00.alo	Missing	['Particles.xml']
p_spmat_splash.alo	Missing	['Particles.xml']
p_self_destruct_effect.alo	Missing	['Particles.xml']
p_weaken_enemy_detonation_effect.alo	Missing	['Particles.xml']
p_explosion_tiny00_dud.alo	Missing	['Particles.xml']
p_explosion_med00_dud.alo	Missing	['Particles.xml']
p_desert_ground_puff.alo	Missing	['Particles.xml']
p_shield_blast_small00.alo	Missing	['Particles.xml']
p_shield_blast_med00.alo	Missing	['Particles.xml']
p_shield_large01.alo	Missing	['Particles.xml']
p_explosion_empire_med00_no_debris.alo	Missing	['Particles.xml']
p_ataa_footpuff_default.alo	Missing	['Particles.xml']
p_atat_footpuff_dirt.alo	Missing	['Particles.xml']
p_splash_wake.alo	Missing	['Particles.xml']
p_atat_footpuff_grass.alo	Missing	['Particles.xml']
p_atat_footpuff_snow.alo	Missing	['Particles.xml']
p_explosion_thermal_small00.alo	Missing	['Particles.xml']
p_explosion_flak01.alo	Missing	['Particles.xml']
p_rain_splash.alo	Missing	['Particles.xml']
p_splash_bullet.alo	Missing	['Particles.xml']
p_splash_wake_continuous.alo	Missing	['Particles.xml']
p_splash_wake_lava.alo	Missing	['Particles.xml']
p_ice_ground_puff.alo	Missing	['Particles.xml']
p_landing_dust_temperate.alo	Missing	['Particles.xml']
p_landing_dust_snow.alo	Missing	['Particles.xml']
p_landing_dust_desert.alo	Missing	['Particles.xml']
p_landing_dust_forest.alo	Missing	['Particles.xml']
p_landing_dust_swamp.alo	Missing	['Particles.xml']
p_landing_dust_volcanic.alo	Missing	['Particles.xml']
p_landing_dust_urban.alo	Missing	['Particles.xml']
p_magnespulse_buildup.alo	Missing	['Particles.xml']
p_magna_explosion.alo	Missing	['Particles.xml']
p_magnepulse_damage00.alo	Missing	['Particles.xml']
p_heal00.alo	Missing	['Particles.xml']
p_force_distract.alo	Missing	['Particles.xml']
p_stun_fx.alo	Missing	['Particles.xml']
p_corrupt_fx.alo	Missing	['Particles.xml']
p_tani_stun.alo	Missing	['Particles.xml']
p_instant_heal.alo	Missing	['Particles.xml']
p_force_push.alo	Missing	['Particles.xml']
p_force_whirlwind.alo	Missing	['Particles.xml']
p_force_convert.alo	Missing	['Particles.xml']
p_lure_object_particle_effect.alo	Missing	['Particles.xml']
p_canderous_lure.alo	Missing	['Particles.xml']
p_at-at_powerup.alo	Missing	['Particles.xml']
p_piet_powerup.alo	Missing	['Particles.xml']
p_replenish_wingmen_particle_effect.alo	Missing	['Particles.xml']
p_weaken_enemy_particle_effect.alo	Missing	['Particles.xml']
p_telekenesis_attack.alo	Missing	['Particles.xml']
p_home_one_target.alo	Missing	['Particles.xml']
p_stealing.alo	Missing	['Particles.xml']
p_smoke_small01.alo	Missing	['Particles.xml']
p_smoke_small00.alo	Missing	['Particles.xml']
p_smoke_med01.alo	Missing	['Particles.xml']
p_smoke_med00.alo	Missing	['Particles.xml']
p_smoke_big01.alo	Missing	['Particles.xml']
p_smoke_big00.alo	Missing	['Particles.xml']
p_shield_small01.alo	Missing	['Particles.xml']
p_shield_med01.alo	Missing	['Particles.xml']
p_bothan_stun_explosion.alo	Missing	['Particles.xml']
p_dazed.alo	Missing	['Particles.xml']
p_invulnerable00.alo	Missing	['Particles.xml']
p_planet_explode_300.alo	Missing	['Particles.xml']
p_fire_small00.alo	Missing	['Particles.xml']
p_fire_med00.alo	Missing	['Particles.xml']
p_fire_big00.alo	Missing	['Particles.xml']
p_fire_huge00.alo	Missing	['Particles.xml']
p_fire_empire_small00.alo	Missing	['Particles.xml']
p_fire_empire_med00.alo	Missing	['Particles.xml']
p_fire_empire_big00.alo	Missing	['Particles.xml']
p_fire_empire_huge00.alo	Missing	['Particles.xml']
p_girder_dust_med00.alo	Missing	['Particles.xml']
p_antilles_rescue.alo	Missing	['Particles.xml']
p_fire_med01.alo	Missing	['Particles.xml']
p_planet_corrupt.alo	Missing	['Particles.xml']
p_planet_corrupt_large.alo	Missing	['Particles.xml']
p_planet_corrupt2.alo	Missing	['Particles.xml']
p_greenglow.alo	Missing	['Particles.xml']
p_blueglow.alo	Missing	['Particles.xml']
p_r_orbital_blast.alo	Missing	['Particles.xml']
p_kraytdestoyer_detonate.alo	Missing	['Particles.xml']
p_detonate_friggin_huge00_backup3_special.alo	Missing	['Particles.xml']
p_orbital_impact_emit4.alo	Missing	['Particles.xml']
p_orbital_impact_ionburst.alo	Missing	['Particles.xml']
w_pick_up_coins.alo	Missing	['Particles.xml']
p_force_confuse.alo	Missing	['Particles.xml']
w_bribery_credit.alo	Missing	['Particles.xml']
p_corrupt_bribery.alo	Missing	['Particles.xml']
p_buildup.alo	Missing	['Particles.xml']
p_pulse_self_destruct_effect.alo	Missing	['Particles.xml']
p_heat_pulsetank.alo	Missing	['Particles.xml']
p_urai_poison.alo	Missing	['Particles.xml']
p_leech_shield.alo	Missing	['Particles.xml']
p_garg_flare.alo	Missing	['Particles.xml']
p_rancor_summon.alo	Missing	['Particles.xml']
p_corrupt_ship.alo	Missing	['Particles.xml']
p_mind_trick.alo	Missing	['Particles.xml']
p_corrupt_system.alo	Missing	['Particles.xml']
p_carbonite_explosion.alo	Missing	['Particles.xml']
p_sensorjammer.alo	Missing	['Particles.xml']
p_tybergun.alo	Missing	['Particles.xml']
p_plasma_burn.alo	Missing	['Particles.xml']
p_nullified_force.alo	Missing	['Particles.xml']
p_repulsor_snare.alo	Missing	['Particles.xml']
p_explosion_galactic_underworld.alo	Missing	['Particles.xml']
w_planet_asteroids.alo	Missing	['Planets.xml']
w_planet_forest01.alo	Missing	['Planets.xml']
p_kraytdestoyer_presuperblast.alo	Missing	['Projectiles.xml']
p_kraytdestoyer_superblast.alo	Missing	['Projectiles.xml']
w_turbolaser_y4c.alo	Missing	['Projectiles.xml']
w_turbolaser_b4c.alo	Missing	['Projectiles.xml']
w_turbolaser_r4c.alo	Missing	['Projectiles.xml']
w_turbolaser_b3.alo	Missing	['Projectiles.xml']
w_turbolaser_r3.alo	Missing	['Projectiles.xml']
p_turbolaser_blue_small.alo	Missing	['Projectiles.xml']
p_hag_shot_gr.alo	Missing	['Projectiles.xml']
w_laserhvyredgroundlandf.alo	Missing	['Projectiles.xml']
p_athered_shot.alo	Missing	['Projectiles.xml']
p_turbolaser_blue_medium.alo	Missing	['Projectiles.xml']
w_laser_eweb_blue.alo	Missing	['Projectiles.xml']
w_turbolaser_b2a.alo	Missing	['Projectiles.xml']
w_turbolaser_r2.alo	Missing	['Projectiles.xml']
w_turbolaser_g6.alo	Missing	['Projectiles.xml']
w_dual_turbolaser_g.alo	Missing	['Projectiles.xml']
w_dual_ion_cannon.alo	Missing	['Projectiles.xml']
w_turbolaser_g4b_bellanni.alo	Missing	['Projectiles.xml']
p_ioncannon_triple.alo	Missing	['Projectiles.xml']
p_ioncannon_quad.alo	Missing	['Projectiles.xml']
w_turbolaser_g4a.alo	Missing	['Projectiles.xml']
w_turbolaser_g.alo	Missing	['Projectiles.xml']
k_plasma_projectile.alo	Missing	['Projectiles.xml']
w_laser_smallg.alo	Missing	['Projectiles.xml']
w_superblast_green_implacable_quad.alo	Missing	['Projectiles.xml']
w_tractor_beam_proyectile.alo	Missing	['Projectiles.xml']
p_turbolaser_ground_aerial_green_double.alo	Missing	['Projectiles.xml']
w_turbolaser_g4aa.alo	Missing	['Projectiles.xml']
w_turbolaser_g33.alo	Missing	['Projectiles.xml']
w_octuple_turbolaser_green.alo	Missing	['Projectiles.xml']
w_turbolaser_g22.alo	Missing	['Projectiles.xml']
w_turbolaser_g2.alo	Missing	['Projectiles.xml']
w_laser_medium.alo	Missing	['Projectiles.xml']
p_lucky.alo	Missing	['Projectiles.xml']
pion_ioncannonshot.alo	Missing	['Projectiles.xml']
w_laser_mediumg.alo	Missing	['Projectiles.xml']
w_laser_large.alo	Missing	['Projectiles.xml']
w_laser_largeg.alo	Missing	['Projectiles.xml']
w_laser_b.alo	Missing	['Projectiles.xml']
ri_saber_spin.alo	Missing	['Projectiles.xml', 'props_story.xml']
w_ewok_rock.alo	Missing	['Projectiles.xml']
w_gungan_projectile.alo	Missing	['Projectiles.xml']
w_proton_projectile.alo	Missing	['Projectiles.xml']
p_hyper_gun_slug.alo	Missing	['Projectiles.xml']
p_ion_cannon00.alo	Missing	['Projectiles.xml']
p_turbolaser_burst_med00_green.alo	Missing	['Projectiles.xml']
p_turbolaser_burst_med00.alo	Missing	['Projectiles.xml']
p_magnepulse_shot.alo	Missing	['Projectiles.xml']
w_thermal_detonator.alo	Missing	['Projectiles.xml']
w_thermal_detonator_empire.alo	Missing	['Projectiles.xml']
w_thermal_detonator_underworld.alo	Missing	['Projectiles.xml']
w_thermal_detonator_rebel.alo	Missing	['Projectiles.xml']
p_seismic_bomb00.alo	Missing	['Projectiles.xml']
w_smallbomb.alo	Missing	['Projectiles.xml', 'props_story.xml']
p_disruptor_projectile.alo	Missing	['Projectiles.xml']
p_kraytdestroyer_superblast_special.alo	Missing	['Projectiles.xml']
p_blueglow2.alo	Missing	['Projectiles.xml']
p_proton_vengance_small.alo	Missing	['Projectiles.xml']
p_proton_vengance.alo	Missing	['Projectiles.xml']
p_mz8shot.alo	Missing	['Projectiles.xml']
w_landmine.alo	Missing	['Projectiles.xml']
p_urai_poison_projectile.alo	Missing	['Projectiles.xml']
w_grenade.alo	Missing	['Projectiles.xml']
w_carbonite_missile.alo	Missing	['Projectiles.xml']
p_ui_spacestation.alo	Missing	['Projectiles.xml']
p_spmat_shot.alo	Missing	['Projectiles_Land.xml']
w_turbolaser_y8.alo	Missing	['Projectiles_Space.xml']
w_turbolaser_y6.alo	Missing	['Projectiles_Space.xml']
w_turbolaser_y4.alo	Missing	['Projectiles_Space.xml']
w_turbolaser_y3.alo	Missing	['Projectiles_Space.xml']
w_turbolaser_r1.alo	Missing	['Projectiles_Space.xml']
ev_tiebomber.alo	Missing	['Props_story.xml', 'squadrons.xml']
ev_tiefighter.alo	Missing	['Props_story.xml', 'squadrons.xml', 'units_hero_empire_titan_squadron.xml']
w_star_destroyer_construction.alo	Missing	['Props_story.xml', 'spaceprops.xml']
w_star_destroyer_construction_d.alo	Missing	['Props_story.xml']
ev_lambdashuttle_space.alo	Missing	['Props_story.xml', 'transportunits.xml']
eb_construction_pod.alo	Missing	['Props_story.xml', 'spaceprops.xml']
w_orbital_resource_container.alo	Missing	['Props_story.xml']
w_orbital_resource_container_small.alo	Missing	['Props_story.xml']
eb_dock00.alo	Missing	['Props_story.xml', 'spaceprops.xml', 'spaceprops.xml', 'spaceprops.xml', 'spaceprops.xml']
eb_dock_break.alo	Missing	['Props_story.xml']
w_crates11.alo	Missing	['Props_story.xml']
w_at-at_construction.alo	Missing	['Props_story.xml']
w_spice_crate.alo	Missing	['Props_story.xml']
ui_tyber_in_jail.alo	Missing	['Props_story.xml']
ni_gmale_urbanprison_a.alo	Missing	['Props_story.xml']
ni_gmale_urbanprison_b.alo	Missing	['Props_story.xml']
ni_gmale_urbanprison_c.alo	Missing	['Props_story.xml']
ni_gmale_urbanprison_d.alo	Missing	['Props_story.xml']
ni_gmale_urbanprison_e.alo	Missing	['Props_story.xml']
ni_piratesoldierprison.alo	Missing	['Props_story.xml']
rv_mfalcon_land.alo	Missing	['Props_story.xml', 'uniqueunits.xml']
eb_cin_basewall-mid.alo	Missing	['Props_story.xml']
w_crates08.alo	Missing	['Props_story.xml']
nv_lds.alo	Missing	['Props_story.xml', 'specialstructures.xml', 'specialstructures.xml']
eb_cin_basewall-thresh.alo	Missing	['Props_story.xml']
w_prison_terminal.alo	Missing	['Props_story.xml']
ev_at-barge.alo	Missing	['Props_story.xml', 'transportunits.xml']
cin_bridge.alo	Missing	['Props_story.xml']
cin_deathstar_high.alo	Missing	['Props_story.xml']
w_planet_deathstar02_ii.alo	Missing	['Props_story.xml']
ev_spmat.alo	Missing	['Props_story.xml']
ev_at-st.alo	Missing	['Props_story.xml', 'units_land_empire_at_st_walker.xml', 'units_land_empire_at_st_walker.xml']
ev_at-aa.alo	Missing	['Props_story.xml']
ev_2mtank.alo	Missing	['Props_story.xml']
ev_tiecrawler.alo	Missing	['Props_story.xml']
w_kraytdragonskull.alo	Missing	['Props_story.xml']
w_kraytdragonribs.alo	Missing	['Props_story.xml']
w_kraytdragontail.alo	Missing	['Props_story.xml']
w_urbanblock_a.alo	Missing	['Props_story.xml']
w_planet_moon_high.alo	Missing	['Props_story.xml']
w_planet_desert-urban_high.alo	Missing	['Props_story.xml']
w_planet_swamp00.alo	Missing	['Props_story.xml']
rv_z-95.alo	Missing	['Props_story.xml', 'spaceunitsfighters.xml', 'spaceunitsfighters.xml']
nb_sandpeople_tent.alo	Missing	['Props_story.xml']
nb_dch.alo	Missing	['Props_story.xml']
nb_dch_b.alo	Missing	['Props_story.xml']
nb_dch_c.alo	Missing	['Props_story.xml']
w_tree_gnarl_00_hi.alo	Missing	['Props_story.xml']
ai_dianoga.alo	Missing	['Props_story.xml']
w_icemntrnge01.alo	Missing	['Props_story.xml']
ai_wampacave.alo	Missing	['Props_story.xml']
w_felucia_plant_06.alo	Missing	['Props_story.xml']
w_felucia_plant_00_tall.alo	Missing	['Props_story.xml']
w_tree_dec_canopy_a.alo	Missing	['Props_story.xml']
w_tempmntrnge00.alo	Missing	['Props_story.xml']
w_gunganhead.alo	Missing	['Props_story.xml']
w_theedbuild_b.alo	Missing	['Props_story.xml']
w_theedbuild_c.alo	Missing	['Props_story.xml']
nb_rancor_cave.alo	Missing	['Props_story.xml']
w_sithtomb.alo	Missing	['Props_story.xml']
w_sithstatue.alo	Missing	['Props_story.xml']
nb_wookiee_tree.alo	Missing	['Props_story.xml']
w_black_box.alo	Missing	['Props_story.xml']
w_theedwall_a.alo	Missing	['Props_story.xml']
w_theedwall_b.alo	Missing	['Props_story.xml']
w_theedwall_c.alo	Missing	['Props_story.xml']
w_observation_tower.alo	Missing	['Props_story.xml']
w_sithartifact_pedestal.alo	Missing	['Props_story.xml']
w_urbancorner_a.alo	Missing	['Props_story.xml']
w_prop_darktrooper_one.alo	Missing	['Props_story.xml']
w_prop_darktrooper_two.alo	Missing	['Props_story.xml']
w_prop_darktroop_three.alo	Missing	['Props_story.xml']
w_bountyhunter.alo	Missing	['Props_story.xml']
w_alarm_light.alo	Missing	['Props_story.xml']
eb_basewall-mid.alo	Missing	['Props_story.xml']
ni_darksideadepts.alo	Missing	['Props_story.xml']
w_prison_bars.alo	Missing	['Props_story.xml']
eb_governorsquarters.alo	Missing	['Props_story.xml']
eb_guardtower.alo	Missing	['Props_story.xml']
nb_cage.alo	Missing	['Props_story.xml']
w_dathbridge.alo	Missing	['Props_story.xml']
w_cloud_car.alo	Missing	['Props_story.xml']
w_bespin_refinery.alo	Missing	['Props_story.xml']
w_prop_deadmen_a.alo	Missing	['Props_story.xml']
w_prop_deadat-st_a.alo	Missing	['Props_story.xml']
w_prop_deadat-st_b.alo	Missing	['Props_story.xml']
w_droidconvey_a.alo	Missing	['Props_story.xml']
w_propdeadst.alo	Missing	['Props_story.xml']
ni_twilek_f_nogun.alo	Missing	['Props_story.xml']
ni_gmale_urban_c_nogun.alo	Missing	['Props_story.xml']
ni_moncalciv_nogun.alo	Missing	['Props_story.xml']
ni_sullustan_nogun.alo	Missing	['Props_story.xml']
ev_executorstardestroyer.alo	Missing	['Props_story.xml']
eb_station_05.alo	Missing	['Props_story.xml']
i_eb_station_level5.alo	Missing	['Props_story.xml']
uv_rz-52boardingship.alo	Missing	['Props_story.xml']
w_jail_bed.alo	Missing	['Props_story.xml']
w_jail_bed_tyber.alo	Missing	['Props_story.xml']
w_urai_hologram.alo	Missing	['Props_story.xml']
w_jaba.alo	Missing	['Props_story.xml']
w_mousedroid_solo.alo	Missing	['Props_story.xml']
w_sithartifact.alo	Missing	['Props_story.xml']
w_shaakskull.alo	Missing	['Props_story.xml']
nb_bothan_building.alo	Missing	['Props_story.xml']
ei_fieldcommander.alo	Missing	['Props_story.xml']
w_sky_smog00.alo	Missing	['Props_story.xml']
w_urbanhalfwall_side.alo	Missing	['Props_story.xml']
w_prop_pwrbox.alo	Missing	['Props_story.xml']
nb_prison.alo	Missing	['Secondarystructures.xml', 'specialstructures.xml']
rb_barracks_small.alo	Missing	['Secondarystructures.xml']
nb_abandon_mining.alo	Missing	['Secondarystructures.xml']
nb_piratebase_sml.alo	Missing	['Secondarystructures.xml']
nb_shuttershieldgen.alo	Missing	['Secondarystructures.xml', 'specialstructures.xml', 'specialstructures.xml']
nb_mercenaryoutfitter.alo	Missing	['Secondarystructures.xml']
nb_commjamstation.alo	Missing	['Secondarystructures.xml', 'specialstructures.xml', 'specialstructures.xml', 'specialstructures.xml']
nb_commjamstation_d.alo	Missing	['Secondarystructures.xml', 'specialstructures.xml']
nb_spacesensornode.alo	Missing	['Secondarystructures.xml', 'specialstructures.xml']
nb_apbase_d.alo	Missing	['Secondarystructures.xml']
w_universe_skydome_star_yellow.alo	Missing	['Spaceprimaryskydomes.xml']
w_universe_skydome_star_white_dwarf.alo	Missing	['Spaceprimaryskydomes.xml']
w_universe_skydome_star_red_giant.alo	Missing	['Spaceprimaryskydomes.xml']
w_universe_skydome_star_purple_giant.alo	Missing	['Spaceprimaryskydomes.xml']
w_universe_skydome_star_brown_dwarf.alo	Missing	['Spaceprimaryskydomes.xml']
w_universe_skydome_star_blue_giant.alo	Missing	['Spaceprimaryskydomes.xml']
w_universe_skydome_neutron_star.alo	Missing	['Spaceprimaryskydomes.xml']
w_stars_greenscreen.alo	Missing	['Spaceprimaryskydomes.xml']
w_stars_blackscreen.alo	Missing	['Spaceprimaryskydomes.xml']
w_stars_purplescreen.alo	Missing	['Spaceprimaryskydomes.xml']
w_asteroid_mass_huge.alo	Missing	['Spaceprops.xml']
w_asteroid_mass_huge_particle.alo	Missing	['Spaceprops.xml']
w_asteroid02.alo	Missing	['Spaceprops.xml', 'specialstructures.xml']
w_asteroid00.alo	Missing	['Spaceprops.xml', 'specialstructures.xml']
w_asteroid01.alo	Missing	['Spaceprops.xml', 'specialstructures.xml']
w_asteroid03.alo	Missing	['Spaceprops.xml', 'specialstructures.xml']
eb_deathstar_trench_a.alo	Missing	['Spaceprops.xml']
eb_deathstar_flat_a.alo	Missing	['Spaceprops.xml']
eb_deathstar_port.alo	Missing	['Spaceprops.xml']
w_lightning.alo	Missing	['Spaceprops.xml']
w_asteroid_mass.alo	Missing	['Spaceprops.xml']
w_asteroid_mass_small.alo	Missing	['Spaceprops.xml']
w_asteroid_mass_med.alo	Missing	['Spaceprops.xml']
w_asteroid_mass_blank.alo	Missing	['Spaceprops.xml']
w_asteroid_mass_med_blank.alo	Missing	['Spaceprops.xml']
w_nebula03.alo	Missing	['Spaceprops.xml']
w_nebula00.alo	Missing	['Spaceprops.xml']
w_nebula01.alo	Missing	['Spaceprops.xml']
w_nebula02.alo	Missing	['Spaceprops.xml']
w_nebula04.alo	Missing	['Spaceprops.xml']
w_nebula03_ion.alo	Missing	['Spaceprops.xml']
w_nebula00_ion.alo	Missing	['Spaceprops.xml']
w_nebula01_ion.alo	Missing	['Spaceprops.xml']
w_nebula02_ion.alo	Missing	['Spaceprops.xml']
w_nebula04_ion.alo	Missing	['Spaceprops.xml']
i_facing_arrow.alo	Missing	['Spaceprops.xml']
w_space_girder00.alo	Missing	['Spaceprops.xml']
w_spacejunk.alo	Missing	['Spaceprops.xml']
w_spacejunk_med.alo	Missing	['Spaceprops.xml']
w_spacejunk_sml.alo	Missing	['Spaceprops.xml']
rv_moncalcruiser_hulk.alo	Missing	['Spaceprops.xml']
rv_moncalcruiser_hp00_f-l.alo	Missing	['Spaceprops.xml']
rv_moncalcruiser_hp00_f-r.alo	Missing	['Spaceprops.xml']
rv_moncalcruiser_hp00_b-l.alo	Missing	['Spaceprops.xml']
rv_moncalcruiser_hp00_b-r.alo	Missing	['Spaceprops.xml']
rv_moncalcruiser_hp00_m-l.alo	Missing	['Spaceprops.xml']
rv_moncalcruiser_hp00_m-r.alo	Missing	['Spaceprops.xml']
rv_nebulonb_hp00_f-l.alo	Missing	['Spaceprops.xml']
rv_nebulonb_hp00_f-r.alo	Missing	['Spaceprops.xml']
rv_nebulonb_hp00_b-l.alo	Missing	['Spaceprops.xml']
rv_nebulonb_hp00_b-r.alo	Missing	['Spaceprops.xml']
ev_acclamator_hp00_f-l.alo	Missing	['Spaceprops.xml']
ev_acclamator_hp00_f-r.alo	Missing	['Spaceprops.xml']
ev_acclamator_hp00_f-c.alo	Missing	['Spaceprops.xml']
ev_acclamator_hp00_b-l.alo	Missing	['Spaceprops.xml']
ev_acclamator_hp00_b-r.alo	Missing	['Spaceprops.xml']
nb_apbase_hp_ll2.alo	Missing	['Spaceprops.xml']
rv_corvette.alo	Missing	['Spaceunitscapital.xml', 'spaceunitscorvettes.xml', 'spaceunitscorvettes.xml', 'spaceunitscorvettes.xml']
rv_corvette_d.alo	Missing	['Spaceunitscapital.xml', 'spaceunitscorvettes.xml']
nv_ipv1.alo	Missing	['Spaceunitscorvettes.xml', 'uniqueunits.xml']
nv_ipv1_d.alo	Missing	['Spaceunitscorvettes.xml']
nv_shadowclaw.alo	Missing	['Spaceunitscorvettes.xml']
nv_shadowclaw_d.alo	Missing	['Spaceunitscorvettes.xml']
rv_corvette_leia.alo	Missing	['Spaceunitscorvettes.xml']
nv_black_sun_fighter.alo	Missing	['Spaceunitsfighters.xml']
nv_pirate_frigate.alo	Missing	['Spaceunitsfrigates.xml']
nv_pirate_frigate_d.alo	Missing	['Spaceunitsfrigates.xml']
w_planet_fleet_ds.alo	Missing	['Spaceunitssupers.xml']
w_cantinatat.alo	Missing	['Specialstructures.xml']
w_huttpalace.alo	Missing	['Specialstructures.xml', 'specialstructures_hutt_cartel.xml']
nb_grandarena.alo	Missing	['Specialstructures.xml']
nv_defensesatellite.alo	Missing	['Specialstructures.xml']
nv_mds.alo	Missing	['Specialstructures.xml']
ub_heavyfactory.alo	Missing	['Specialstructures_Black_Sun.xml', 'specialstructures_hutt_cartel.xml', 'specialstructures_underworld.xml']
ub_droidworks.alo	Missing	['Specialstructures_CIS.xml', 'specialstructures_underworld.xml']
eb_magnepulsecannon.alo	Missing	['Specialstructures_Empire.xml']
rb_hypervelocitygun.alo	Missing	['Specialstructures_Empire.xml']
rb_barracks.alo	Missing	['Specialstructures_Rebel.xml']
rb_ioncannon.alo	Missing	['Specialstructures_Rebel.xml']
ub_palace.alo	Missing	['Specialstructures_underworld.xml']
ub_barracks.alo	Missing	['Specialstructures_underworld.xml']
nb_bunker.alo	Missing	['Specialstructures_underworld.xml']
eb_testbunker.alo	Missing	['Specialstructures_underworld.xml']
rb_bunker.alo	Missing	['Specialstructures_underworld.xml']
ub_bunker.alo	Missing	['Specialstructures_underworld.xml']
ub_gravcontrolgen.alo	Missing	['Specialstructures_underworld.xml']
rv_xwing.alo	Missing	['Squadrons.xml', 'uniqueunits.xml', 'units_space_black_sun_v_wing.xml', 'units_space_hutt_v_wing.xml', 'units_hero_rebel_ahsoka_tano.xml', 'units_hero_rebel_lukeskywalker.xml', 'units_hero_rebel_vanguard_squadron.xml', 'units_space_rebel_x-wing.xml']
rb_station_01.alo	Missing	['Starbases.xml']
rb_station_02.alo	Missing	['Starbases.xml']
rb_station_03.alo	Missing	['Starbases.xml']
rb_station_04.alo	Missing	['Starbases.xml']
eb_station_01.alo	Missing	['Starbases.xml']
ub_01_station.alo	Missing	['Starbases_underworld.xml']
i_ub_01_station.alo	Missing	['Starbases_underworld.xml']
ub_01_station_d.alo	Missing	['Starbases_underworld.xml']
ub_02_station.alo	Missing	['Starbases_underworld.xml']
i_ub_02_station.alo	Missing	['Starbases_underworld.xml']
ub_02_station_d.alo	Missing	['Starbases_underworld.xml']
ub_03_station.alo	Missing	['Starbases_underworld.xml']
i_ub_03_station.alo	Missing	['Starbases_underworld.xml']
ub_03_station_d.alo	Missing	['Starbases_underworld.xml']
ub_04_station.alo	Missing	['Starbases_underworld.xml']
i_ub_04_station.alo	Missing	['Starbases_underworld.xml']
ub_04_station_d.alo	Missing	['Starbases_underworld.xml']
ub_05_station.alo	Missing	['Starbases_underworld.xml']
i_ub_05_station.alo	Missing	['Starbases_underworld.xml']
ub_05_station_d.alo	Missing	['Starbases_underworld.xml']
ev_imperialcraft_space_d.alo	Missing	['Transportunits.xml']
ev_at-barge_land.alo	Missing	['Transportunits.xml']
ev_at-barge_d.alo	Missing	['Transportunits.xml']
rv_transport_d.alo	Missing	['Transportunits.xml']
ev_lambdashuttle.alo	Missing	['Transportunits.xml']
ev_lambdashuttle_space_d.alo	Missing	['Transportunits.xml']
rv_herotransport.alo	Missing	['Transportunits.xml']
rv_herotransport_d.alo	Missing	['Transportunits.xml']
rv_nebulonb.alo	Missing	['Uniqueunits.xml', 'units_space_black_sun_nebulon_b.xml', 'units_space_hutt_nebulon_b.xml', 'units_space_rebel_nebulon_b.xml']
ev_tieadvanced.alo	Missing	['Uniqueunits.xml']
rv_mfalcon.alo	Missing	['Uniqueunits.xml']
rv_mfalcon_backwards.alo	Missing	['Uniqueunits.xml']
rv_mfalcon_d.alo	Missing	['Uniqueunits.xml']
rv_mfalcon_backwards_d.alo	Missing	['Uniqueunits.xml']
ev_slave1.alo	Missing	['Uniqueunits.xml']
ev_slave1_space.alo	Missing	['Uniqueunits.xml']
ev_slave1_space_d.alo	Missing	['Uniqueunits.xml']
nv_vwing.alo	Missing	['Uniqueunits.xml']
rv_antilliesvette.alo	Missing	['Uniqueunits.xml']
rv_antilliesvette_d.alo	Missing	['Uniqueunits.xml']
nv_jedicruiser.alo	Missing	['Uniqueunits.xml']
nv_jedicruiser_d.alo	Missing	['Uniqueunits.xml']
nv_swampspeeder.alo	Missing	['Uniqueunits.xml']
nv_swampspeeder_e.alo	Missing	['Uniqueunits.xml']
nv_swampspeeder_r.alo	Missing	['Uniqueunits.xml']
nv_swampspeeder_p.alo	Missing	['Uniqueunits.xml']
nv_swampspeeder_chew.alo	Missing	['Uniqueunits.xml']
ev_podwalker.alo	Missing	['Uniqueunits.xml']
nv_moldycrow_landing.alo	Missing	['Uniqueunits.xml']
nv_moldycrow.alo	Missing	['Uniqueunits.xml']
cis_b1_battledroid_disemberment.alo	Missing	['Units_land_cis_battledroid.xml', 'units_land_cis_battledroid_heavy.xml', 'units_land_cis_battledroid_specialist.xml']
cis_b1_battledroid_dismemberment2.alo	Missing	['Units_land_cis_battledroid.xml', 'units_land_cis_battledroid_heavy.xml', 'units_land_cis_battledroid_specialist.xml']
cis_b1_battledroid_dismemberment3.alo	Missing	['Units_land_cis_battledroid.xml', 'units_land_cis_battledroid_heavy.xml', 'units_land_cis_battledroid_specialist.xml']
cis_b1_battledroid_explode_01.alo	Missing	['Units_land_cis_battledroid.xml', 'units_land_cis_battledroid_heavy.xml', 'units_land_cis_battledroid_specialist.xml']
cis_sbd_v2.alo	Missing	['Units_land_cis_super_battledroid.xml']
cis_sbd.alo	Missing	['Units_land_cis_super_battledroid.xml']
sev_snailtank_dc.alo	Missing	['Units_land_cis_enforcer_tank.xml']
cv_bulwark_mk1_rebel.alo	Missing	['Units_space_Confederacy_bulwark.xml']
hu_multi_hvy_skiff_turret.alo	Missing	['Hardpoints_Skiff.xml']
ev_stardestroyer_d.alo	Missing	['Units_hero_empire_Megador.xml']
ev_stardestroyer_dead.alo	Missing	['Units_hero_empire_Megador.xml']
ev_stardestroyer_hulk.alo	Missing	['Units_space_Empire_Star_Destroyer_II.xml']
escort_carrier.alo	Missing	['Units_space_empire_carrier.xml']
ev_interdictor.alo	Missing	['Units_Space_Empire_Immobilizer.xml']
rv_xwing_landing.alo	Missing	['Units_hero_rebel_Ahsoka_Tano.xml', 'units_hero_rebel_lukeskywalker.xml']
rv_gargantuan.alo	Missing	['Units_hero_rebel_Garm_Bel_Iblis.xml']
rv_gargantuan_dc.alo	Missing	['Units_hero_rebel_Garm_Bel_Iblis.xml']
ri_difleman.alo	Missing	['Units_Land_Rebel_Commando.xml']
desert_plex_soldier.alo	Missing	['Units_land_Rebel_Desert_PlexSoldier.xml']
ri_plexsoldier.alo	Missing	['Units_land_Rebel_Plex_Soldier.xml']
rv_awing.alo	Missing	['Units_space_rebel_A-Wing.xml']
hammerhead.alo	Missing	['Units_Space_Rebel_Hammerhead.xml']
pe_executor	Missing	['age_of_strife.alo', 'arbitrator.alo', 'death_lives.alo', 'ev_eclipse_sloane.alo', 'ev_empress.alo', 'ev_executor_star_dreadnaught.alo', 'ev_intimidator.alo', 'knight_hammer.alo', 'mandator_pirates.alo', 'release_the_fury.alo', 'rv_lusankya.alo', 'vengeance.alo', 'wrath_of_war.alo']
pe_jedicruiser_med	Missing	['allegiance_star_destroyer.alo', 'ev_enforcership.alo', 'ev_praetor_advanced.alo', 'ev_praetor_ssd.alo', 'ev_titan_ssd.alo', 'ev_venator.alo', 'f_carrack.alo', 'f_imp_hero.alo', 'f_lucrehulk.alo', 'f_mc104.alo', 'f_mc50.alo', 'f_providence.alo', 'f_recusant.alo', 'f_thrawnsd.alo', 'f_titan.alo', 'f_victory.alo', 'f_victoryii.alo', 'f_victoryiii.alo', 'lucrehulk.alo', 'mc104.alo', 'mc104_star_dreadnaught.alo', 'mc50.alo', 'mc80a_wingless.alo', 'mc80_a.alo', 'mc80_liberty.alo', 'mc85.alo', 'mc85_star_destroyer.alo', 'praetor_advanced.alo', 'providence.alo', 'recusant.alo', 'rejuvenatorsd.alo', 'rv_mc80.alo', 'rv_mon_cal80.alo', 'titan_star_destroyer.alo', 'uv_invencible.alo', 'victoryii.alo', 'victoryiii.alo', 'vindicator.alo']
pte_tartanengine_lrg	Missing	['allegiance_star_destroyer.alo', 'f_strident.alo', 'strident_gold_star_destroyer.alo', 'strident_star_destroyer.alo']
p_hp_alliancex6	Missing	['ar_nv_golani.alo', 'ar_nv_golanii.alo', 'ar_nv_golaniii.alo', 'cis_station_level3_d.alo', 'cis_station_level4.alo', 'cis_station_level4_d.alo', 'cis_station_level5.alo', 'cis_station_level5_d.alo', 're_raddus.alo', 'rvre_raddus.alo', 'w_kuat_ring_new_part02.alo', 'w_kuat_ring_new_part03.alo', 'w_kuat_ring_new_part04.alo', 'w_kuat_ring_new_part05.alo', 'w_kuat_ring_new_part06.alo', 'w_kuat_ring_new_part07.alo', 'w_planet_kuat.alo']
p_hp_alliancex5	Missing	['ar_nv_golani.alo', 'ar_nv_golanii.alo', 'ar_nv_golaniii.alo', 'dreadnoughtiv.alo', 'evfo_onager.alo', 'evfo_onager_d.alo', 'ev_resurgent_d.alo', 're_raddus.alo', 'rvre_raddus.alo']
pi_damage_elec_sd00	Missing	['ar_nv_golani.alo', 'ar_nv_golanii.alo', 'ar_nv_golaniii.alo', 'assaultfrigate2.alo', 'blue_diver.alo', 'cis_station_level4.alo', 'cis_station_level5.alo', 'cis_v_munificent.alo', 'dominator_i-class_star_destroyer.alo', 'dreadnoughtiv.alo', 'evfo_onager.alo', 'ev_acclamator_assault_ship.alo', 'ev_allegiance.alo', 'ev_bellator.alo', 'ev_enforcership.alo', 'ev_gladiator.alo', 'ev_immobilizer.alo', 'ev_resurgent.alo', 'ev_secutor.alo', 'ev_stardestroyer.alo', 'ev_venator.alo', 'ev_victorystardestroyer.alo', 'familybase_01.alo', 'familybase_02.alo', 'familybase_03.alo', 'familybase_04.alo', 'familybase_05.alo', 'finalizer_sd.alo', 'himera_star_destroyer.alo', 'imperial_i-class_star_destroyer.alo', 'imperial_ii-class_star_destroyer.alo', 'imperial_ii-class_star_destroyer_black.alo', 'imperious.alo', 'kedalbebattleship.alo', 'kraytclassdestroyer.alo', 'mandalorian_cruiser1.alo', 'mandalorian_cruiser2.alo', 'mc80wingless.alo', 'mc80_wingless.alo', 'mc_blue_diver.alo', 'onager_star_destroyer.alo', 'rep_light_cruiser.alo', 'rep_starbase_level_01.alo', 'rep_starbase_level_02.alo', 'rep_starbase_level_03.alo', 'rep_starbase_level_04.alo', 'rep_starbase_level_05.alo', 'rev_mandator.alo', 're_raddus.alo', 'rvre_raddus.alo', 'rv_assault_frigatemkiiix.alo', 'rv_attack_tank.alo', 'rv_mandator.alo', 'rv_mc108.alo', 'rv_mc112.alo', 'rv_mc80ajm.alo', 'rv_mc80wl.alo', 'rv_mc85.alo', 'rv_mediator.alo', 'uv_invencible.alo', 'uv_kedalbebattleship.alo', 'uv_nebulon_c.alo', 'venator-class_star_destroyer.alo', 'venator_star_destroyer.alo', 'vindicator.alo', 'xyston_destroyer.alo', 'xyston_destroyerii.alo']
pptw_ptwsa8	Missing	['ar_nv_golani.alo', 'ar_nv_golanii.alo', 'ar_nv_golaniii.alo']
p_hp_firestationx1	Missing	['ar_nv_golani.alo', 'ar_nv_golanii.alo', 'ar_nv_golaniii.alo', 'ev_resurgent.alo', 'ev_resurgent_d.alo']
p_hp_alliancex2	Missing	['ar_nv_golani.alo', 'ar_nv_golanii.alo', 'ar_nv_golaniii.alo', 'cis_station_level1_d.alo', 'cis_station_level2_d.alo', 'cis_station_level3_d.alo', 'cis_station_level4.alo', 'cis_station_level4_d.alo', 'cis_station_level5.alo', 'cis_station_level5_d.alo', 'dreadnoughtiv.alo', 'evfo_onager.alo', 'evfo_onager_d.alo', 'ev_acclamator_assault_ship.alo', 'ev_allegiance_d.alo', 'ev_assertor_ssd.alo', 'ev_bellator.alo', 'ev_enforcership.alo', 'ev_gladiator.alo', 'ev_resurgent.alo', 'ev_resurgent_d.alo', 'ev_secutor.alo', 'mc80wingless.alo', 're_raddus.alo', 'rvre_raddus.alo', 'rvre_starhawk.alo', 'rvre_starhawk_d.alo', 'rvre_vigil.alo', 'rv_assault_frigatemkiiix.alo', 'rv_mc108.alo', 'rv_mc112.alo', 'rv_mc80ajm.alo', 'rv_mc85.alo', 'rv_mc85_d.alo', 'rv_mediator.alo', 'rv_mediator_d.alo', 'uv_invencible.alo', 'vindicator.alo', 'w_kuat_ring_new_part02.alo', 'w_kuat_ring_new_part03.alo', 'w_kuat_ring_new_part04.alo', 'w_kuat_ring_new_part05.alo', 'w_planet_kuat.alo']
p_blink_white	Missing	['assaultfrigate2.alo', 'empire_shieldgate_lvl1.alo', 'empire_shieldgate_lvl2.alo', 'empire_shieldgate_lvl3.alo', 'empire_shieldgate_lvl4.alo', 'empire_shieldgate_lvl5.alo', 'ev_imperialcraft.alo', 'ev_imperialcraft_loader.alo', 'ev_imperialcraft_loader_space.alo', 'ev_imperialcraft_space.alo', 'mv_kandosii.alo', 'nb_black_sun_bmphq.alo']
p_imperial_midshipsmoke_0	Missing	['assaultfrigate_death.alo', 'w_kuat_ring_new_part07_d.alo']
p_explosion_chain3_e	Missing	['assaultfrigate_death.alo', 'cis_station_level1_d.alo', 'cis_station_level2_d.alo', 'cis_station_level3_d.alo', 'cis_station_level4_d.alo', 'cis_station_level5_d.alo', 'ev_victory1_death.alo', 'imperious_d.alo', 'rep_starbase_level_01_d.alo', 'rep_starbase_level_02_d.alo', 'rep_starbase_level_03_d.alo', 'rep_starbase_level_04_d.alo', 'rep_starbase_level_05_d.alo', 'w_kuat_ring_new_part06_d.alo']
pe_assertor	Missing	['assertor_super_star_destroyer.alo', 'ev_assertor_ssd.alo']
pptw_ptwsa4	Missing	['bellator_super_star_destroyer.alo', 'ev_allegiance.alo', 'ev_bellator.alo', 'ev_enforcership.alo', 'ev_gladiator.alo', 'ev_secutor.alo', 'mc112_star_cruiser.alo', 'raddus_star_cruiser.alo', 're_raddus.alo', 'rvre_raddus.alo', 'rv_mc108.alo', 'rv_mc112.alo', 'rv_mediator.alo', 'secutor_star_destroyer.alo', 'vindicator.alo', 'vindicator_sd.alo']
pe_bloodstar_l	Missing	['bloodstar.alo']
pe_bloodstar_m	Missing	['bloodstar.alo']
pe_bloodstar_s	Missing	['bloodstar.alo']
p_explosion_chain	Missing	['bloodstar_d.alo', 'ev_allegiance_d.alo', 'w_kuat_ring_new_part02_d.alo', 'w_kuat_ring_new_part03_d.alo', 'w_kuat_ring_new_part04_d.alo', 'w_kuat_ring_new_part05_d.alo']
p_explosion_huge00	Missing	['bloodstar_d.alo', 'blue_diver_d.alo', 'cis_station_level1_d.alo', 'cis_station_level2_d.alo', 'cis_station_level3_d.alo', 'cis_station_level4_d.alo', 'cis_station_level5_d.alo', 'ev_allegiance_d.alo', 'ev_quasar_d.alo', 'familybase_01_d.alo', 'familybase_02_d.alo', 'familybase_03_d.alo', 'familybase_04_d.alo', 'familybase_05_d.alo', 'hutt_cruiser_d.alo', 'imp_light_cruiser_d.alo', 'nv_jovan_station_d.alo', 'profundity_d.alo', 'reb_pelta_carrier_d.alo', 'reb_quasar_sato_d.alo', 'rep_light_cruiser_d.alo', 'rep_pelta_d.alo', 'rv_mediator_cruiser_d.alo', 'rv_quasar_sato_d.alo', 'uv_nebulon_c_d.alo', 'w_kuat_ring_new_part02_d.alo', 'w_kuat_ring_new_part03_d.alo', 'w_kuat_ring_new_part04_d.alo', 'w_kuat_ring_new_part05_d.alo']
pe_blue_diver_l	Missing	['blue_diver.alo', 'mc_blue_diver.alo']
pe_blue_diver_m	Missing	['blue_diver.alo', 'mc_blue_diver.alo']
pe_blue_diver_s	Missing	['blue_diver.alo', 'mc_blue_diver.alo']
p_explosion_big00	Missing	['blue_diver_d.alo', 'familybase_01.alo', 'familybase_02.alo', 'familybase_03.alo', 'familybase_04.alo', 'familybase_05.alo', 'nv_dread_die.alo', 'reb_pelta_carrier_d.alo', 'rep_pelta_d.alo', 'rvre_vigil_d.alo', 'rv_mediator_cruiser_d.alo', 'uv_interceptoriv_d.alo', 'uv_nebulon_c_d.alo', 'w_kuat_ring_new_part07_d.alo']
p_explosion_chain3	Missing	['blue_diver_d.alo', 'ev_allegiance_d.alo', 'ev_assertor_ssd_d.alo', 'ev_bellator_d.alo', 'ev_quasar_d.alo', 'familybase_01_d.alo', 'familybase_02_d.alo', 'familybase_03_d.alo', 'familybase_04_d.alo', 'familybase_05_d.alo', 'hutt_cruiser_d.alo', 'imp_light_cruiser_d.alo', 'nv_jovan_station_d.alo', 'profundity_d.alo', 'reb_pelta_carrier_d.alo', 'reb_quasar_sato_d.alo', 'rep_light_cruiser_d.alo', 'rep_pelta_d.alo', 'rev_mandator_d.alo', 'rvre_vigil_d.alo', 'rv_mc108_d.alo', 'rv_quasar_sato_d.alo', 'salvator_d.alo', 'starforge_d.alo', 'uv_nebulon_c_d.alo', 'viscount_d.alo']
p_hp_stardestroyer_damage	Missing	['blue_diver_d.alo', 'cis_v_munificent.alo', 'dreadnought.alo', 'ev_venator.alo', 'familybase_01_d.alo', 'familybase_02_d.alo', 'familybase_03_d.alo', 'familybase_04_d.alo', 'familybase_05_d.alo', 'rv_mediator_cruiser_d.alo', 'rv_moncalcruiser.alo', 'w_kuat_ring_new_part02_d.alo', 'w_kuat_ring_new_part03_d.alo', 'w_kuat_ring_new_part04_d.alo', 'w_kuat_ring_new_part05_d.alo']
p_rebcapdestroy	Missing	['blue_diver_d.alo', 'rev_mandator_d.alo', 'rv_mediator_cruiser_d.alo']
p_explosion_chain03	Missing	['blue_diver_d.alo']
p_electricalstatic	Missing	['cis_aat.alo', 'cis_aat_cw.alo', 'cis_hailfire.alo', 'cis_hailfire_urban.alo', 'cis_snail_tank.alo', 'evfo_atat.alo', 'ev_at-at.alo', 'ev_atact.alo', 'ev_atar.alo', 'ev_at_dt.alo', 'ev_at_mp.alo', 'ev_century_tank.alo', 'ev_iftx.alo', 'ev_tx_tank.alo', 'gargantuan_advanced.alo', 'hu_hvy_sail_barge.alo', 'hu_multi_skiff.alo', 'hu_pirate_speeder_2.alo', 'mandalorian_speeder.alo', 'nv_podwalker.alo', 'rev_atpt.alo', 'rv_attack_tank.alo', 'rv_snowspeeder.alo', 'rv_t12b.alo', 'rv_t1bx.alo', 'rv_t2b-aav.alo', 'rv_t2b-aav_d.alo', 'rv_t3bx.alo', 'rv_t4_b.alo', 'rv_t5bx.alo', 'rv_t5bx_d.alo', 'rv_t6bx.alo', 'rv_t6bxx.alo', 'rv_t6bx_d.alo', 'rv_t8bx.alo', 'rv_t8bx_d.alo', 'rv_tb10.alo', 'rv_v19_landspeeder.alo', 'trooper_transport.alo']
p_smoke_small_sputter	Missing	['cis_aat.alo', 'cis_aat_cw.alo', 'cis_aa_turret.alo', 'cis_hailfire.alo', 'cis_hailfire_urban.alo', 'cis_infantry_turret.alo', 'cis_snail_tank.alo', 'cis_vehicle_turret.alo', 'evfo_atat.alo', 'ev_at-at.alo', 'ev_atact.alo', 'ev_at_dt.alo', 'ev_at_mp.alo', 'ev_bike.alo', 'ev_iftx.alo', 'ev_juggernauta5.alo', 'ev_tx_tank.alo', 'hu_hvy_sail_barge.alo', 'hu_multi_skiff.alo', 'nv_podwalker.alo', 'pirate_speeder.alo', 'rev_atpt.alo', 'rv_aac2.alo', 'rv_aac2_d.alo', 'rv_aac3.alo', 'rv_aac_hovertank.alo', 'rv_snowspeeder.alo', 'rv_t12b.alo', 'rv_t1bx.alo', 'rv_t2b-aav.alo', 'rv_t2b-aav_d.alo', 'rv_t3bx.alo', 'rv_t5bx.alo', 'rv_t5bx_d.alo', 'rv_t6bx.alo', 'rv_t6bxx.alo', 'rv_t6bx_d.alo', 'rv_t8bx.alo', 'rv_t8bx_d.alo', 'rv_tb10.alo', 'rv_v19_landspeeder.alo', 'trooper_transport.alo']
p_smoke_small_thin	Missing	['cis_aat.alo', 'cis_aat_cw.alo', 'cis_aa_turret.alo', 'cis_hailfire.alo', 'cis_hailfire_urban.alo', 'cis_infantry_turret.alo', 'cis_snail_tank.alo', 'cis_vehicle_turret.alo', 'evfo_atat.alo', 'ev_at-at.alo', 'ev_atact.alo', 'ev_atar.alo', 'ev_at_dt.alo', 'ev_at_mp.alo', 'ev_century_tank.alo', 'ev_iftx.alo', 'ev_juggernauta5.alo', 'ev_tx_tank.alo', 'gargantuan_advanced.alo', 'hu_hvy_sail_barge.alo', 'hu_multi_skiff.alo', 'nv_podwalker.alo', 'rev_atpt.alo', 'rv_aac2.alo', 'rv_aac2_d.alo', 'rv_aac3.alo', 'rv_aac_hovertank.alo', 'rv_attack_tank.alo', 'rv_snowspeeder.alo', 'rv_t12b.alo', 'rv_t1bx.alo', 'rv_t2b-aav.alo', 'rv_t2b-aav_d.alo', 'rv_t3bx.alo', 'rv_t4_b.alo', 'rv_t5bx.alo', 'rv_t5bx_d.alo', 'rv_t6bx.alo', 'rv_t6bxx.alo', 'rv_t6bx_d.alo', 'rv_t8bx.alo', 'rv_t8bx_d.alo', 'rv_tb10.alo', 'rv_v19_landspeeder.alo', 'trooper_transport.alo']
p_explosion_med01	Missing	['cis_aat.alo', 'cis_aat_cw.alo', 'gargantuan_advanced.alo', 'nb_black_sun_bmphq.alo', 'rv_aac2_d.alo', 'rv_t12b.alo', 'rv_t5bx_d.alo', 'rv_t6bx_d.alo', 'rv_tb10.alo']
p_hover_generic	Missing	['cis_aat.alo', 'cis_aat_cw.alo']
p_girder_sparks00	Missing	['cis_aa_turret.alo', 'cis_infantry_turret.alo', 'cis_vehicle_turret.alo']
p_girder_dust_small00	Missing	['cis_aa_turret.alo', 'cis_infantry_turret.alo', 'cis_vehicle_turret.alo']
p_electricalstatic3	Missing	['cis_aa_turret.alo', 'cis_infantry_turret.alo', 'cis_snail_tank.alo', 'cis_vehicle_turret.alo', 'evfo_atat.alo', 'ev_at-at.alo', 'ev_atact.alo', 'ev_atar.alo', 'ev_at_dt.alo', 'ev_at_mp.alo', 'ev_bike.alo', 'ev_iftx.alo', 'ev_tx_tank.alo', 'hu_multi_skiff.alo', 'nv_podwalker.alo', 'pirate_speeder.alo', 'rv_snowspeeder.alo', 'rv_t1bx.alo', 'rv_t2b-aav_d.alo', 'rv_t3bx.alo', 'rv_t5bx.alo', 'rv_t5bx_d.alo', 'rv_t6bx.alo', 'rv_t6bxx.alo', 'rv_t6bx_d.alo', 'rv_t8bx.alo', 'rv_t8bx_d.alo', 'rv_v19_landspeeder.alo']
p_explosion_small01	Missing	['cis_aa_turret.alo', 'cis_infantry_turret.alo', 'cis_vehicle_turret.alo', 'nb_black_sun_bmphq.alo']
p_desert_ground_dust	Missing	['cis_bx_commando.alo', 'cis_bx_commando_captain.alo', 'ei_gunner.alo', 'ui_falleen_assassin.alo']
p_explosion_big02	Missing	['cis_hailfire.alo', 'cis_hailfire_urban.alo']
p_explosion_blast01	Missing	['cis_hailfire.alo', 'cis_hailfire_urban.alo', 'cis_station_level5_d.alo', 'ev_acclamator_assault_ship_d.alo', 'ev_gladiator_d.alo', 'rv_mc108_d.alo', 'rv_mc112_d.alo']
p_electricalstatic2	Missing	['cis_snail_tank.alo', 'evfo_atat.alo', 'ev_at-at.alo', 'ev_atact.alo', 'ev_iftx.alo', 'ev_tx_tank.alo', 'hu_multi_skiff.alo', 'nv_podwalker.alo', 'rv_aac2.alo', 'rv_aac2_d.alo', 'rv_aac3.alo', 'rv_aac_hovertank.alo', 'rv_t2b-aav.alo', 'rv_t2b-aav_d.alo', 'rv_t4_b.alo', 'rv_t6bx_d.alo']
p_hp_alliancex1	Missing	['cis_station_level1_d.alo', 'cis_station_level2_d.alo', 'cis_station_level3_d.alo', 'cis_station_level4.alo', 'cis_station_level4_d.alo', 'cis_station_level5.alo', 'cis_station_level5_d.alo', 'dreadnoughtiv.alo', 'evfo_onager.alo', 'evfo_onager_d.alo', 'ev_allegiance_d.alo', 'ev_assertor_ssd.alo', 'ev_bellator.alo', 'ev_secutor.alo', 'mc80wingless.alo', 're_raddus.alo', 'rvre_raddus.alo', 'rvre_starhawk.alo', 'rvre_starhawk_d.alo', 'rv_mc108.alo', 'rv_mc112.alo', 'rv_mc80ajm.alo', 'rv_mediator.alo', 'rv_mediator_d.alo', 'uv_invencible.alo']
p_hp_alliancex8	Missing	['cis_station_level1_d.alo', 'cis_station_level2_d.alo', 'cis_station_level3_d.alo', 'cis_station_level4.alo', 'cis_station_level4_d.alo', 'cis_station_level5.alo', 'cis_station_level5_d.alo']
p_fire_med01	Missing	['cis_station_level1_d.alo', 'cis_station_level2_d.alo', 'cis_station_level3_d.alo', 'cis_station_level4_d.alo', 'cis_station_level5_d.alo', 'cis_v_munificent.alo', 'evfo_atat.alo', 'ev_at-at.alo', 'ev_atact.alo', 'ev_venator.alo', 'rev_mandator.alo', 'rev_mandator_d.alo', 'rv_attack_tank_d.alo', 'rv_mandator.alo', 'rv_t12b_d.alo', 'rv_tb10_d.alo']
p_uwstation_death	Missing	['cis_station_level1_d.alo', 'cis_station_level2_d.alo', 'cis_station_level3_d.alo', 'cis_station_level4_d.alo']
p_rb_station_damage	Missing	['cis_station_level1_d.alo', 'cis_station_level2_d.alo', 'cis_station_level3_d.alo', 'cis_station_level4.alo', 'cis_station_level4_d.alo', 'cis_station_level5.alo', 'cis_station_level5_d.alo', 'ev_immobilizer.alo', 'ev_quasar_d.alo', 'familybase_01.alo', 'familybase_01_d.alo', 'familybase_02.alo', 'familybase_02_d.alo', 'familybase_03.alo', 'familybase_03_d.alo', 'familybase_04.alo', 'familybase_04_d.alo', 'familybase_05.alo', 'familybase_05_d.alo', 'finalizer_sd.alo', 'hutt_cruiser.alo', 'hutt_cruiser_d.alo', 'imp_light_cruiser_d.alo', 'nv_jovan_station.alo', 'nv_jovan_station_d.alo', 'profundity.alo', 'profundity_d.alo', 'reb_quasar_sato_d.alo', 'rep_light_cruiser.alo', 'rep_light_cruiser_d.alo', 'rep_starbase_level_01.alo', 'rep_starbase_level_01_d.alo', 'rep_starbase_level_02.alo', 'rep_starbase_level_02_d.alo', 'rep_starbase_level_03.alo', 'rep_starbase_level_03_d.alo', 'rep_starbase_level_04.alo', 'rep_starbase_level_04_d.alo', 'rep_starbase_level_05.alo', 'rep_starbase_level_05_d.alo', 'rev_mandator.alo', 'rev_mandator_d.alo', 'rv_mandator.alo', 'rv_quasar_sato_d.alo', 'salvator_d.alo', 'uv_nebulon_c.alo', 'uv_nebulon_c_d.alo', 'viscount.alo', 'viscount_d.alo']
p_explosion_huge03_e	Missing	['cis_station_level1_d.alo', 'cis_station_level2_d.alo', 'cis_station_level3_d.alo', 'cis_station_level4_d.alo', 'cis_station_level5_d.alo', 'rep_starbase_level_01_d.alo', 'rep_starbase_level_02_d.alo', 'rep_starbase_level_03_d.alo', 'rep_starbase_level_04_d.alo', 'rep_starbase_level_05_d.alo', 'w_kuat_ring_new_part06_d.alo']
p_explosion_huge01x	Missing	['cis_station_level5_d.alo', 'ev_allegiance_d.alo', 'rvre_starhawk_d.alo', 'rv_mc85_d.alo']
p_explosion_huge03_ex	Missing	['cis_station_level5_d.alo', 'ev_allegiance_d.alo', 'ev_gladiator_d.alo', 'rvre_starhawk_d.alo', 'rv_mc85_d.alo']
p_explosion_chain_e	Missing	['cis_station_level5_d.alo', 'rep_starbase_level_01_d.alo', 'rep_starbase_level_02_d.alo', 'rep_starbase_level_03_d.alo', 'rep_starbase_level_04_d.alo', 'rep_starbase_level_05_d.alo', 'w_kuat_ring_new_part06_d.alo']
p_imperial_midshipsmoke	Missing	['cis_station_level5_d.alo', 'dreadnought_d.alo', 'ev_victorystardestroyer_d.alo', 'f_dreadnought_d.alo', 'f_imp_hero_d.alo', 'f_independence_d.alo', 'f_lucrehulk_d.alo', 'f_mc104_d.alo', 'f_mc40b_d.alo', 'f_mc50_d.alo', 'f_mc60_d.alo', 'f_mc80a_d.alo', 'f_mc80b_d.alo', 'f_mc80c_d.alo', 'f_mc85_d.alo', 'f_mc90_d.alo', 'f_providence_d.alo', 'f_recusant_d.alo', 'f_strident_d.alo', 'f_thrawnsd_d.alo', 'f_titan_d.alo', 'f_victory_d.alo', 'rejuvenatorsd_d.alo', 'rv_mediator_d.alo']
hp_b-m_emitdamage	Missing	['cis_v_munificent.alo', 'ev_venator.alo']
hp_f-c_emitdamage	Missing	['cis_v_munificent.alo', 'ev_venator.alo']
hp_e_emitdamage	Missing	['cis_v_munificent.alo', 'ev_venator.alo']
spawn_00_emitdamage	Missing	['cis_v_munificent.alo', 'ev_venator.alo']
spawn_01_emitdamage	Missing	['cis_v_munificent.alo', 'ev_venator.alo']
hp_frontturret_l_emitdamage	Missing	['cis_v_munificent.alo', 'ev_venator.alo']
hp_frontturret_r_emitdamage	Missing	['cis_v_munificent.alo', 'ev_venator.alo']
pe_munificentengines	Missing	['cis_v_munificent.alo']
pe_bulwark_mk1_large	Missing	['cv_bulwark_mk1.alo']
pe_bulwark_mk1_small	Missing	['cv_bulwark_mk1.alo']
pe_viscount_l	Missing	['dark_mercy_star_defender.alo', 'new_alderaan_defender.alo', 'rv_salvator.alo', 'rv_viscount_class_star_defender.alo', 'viscount.alo']
pe_viscount_m	Missing	['dark_mercy_star_defender.alo', 'new_alderaan_defender.alo', 'rv_salvator.alo', 'rv_viscount_class_star_defender.alo', 'viscount.alo']
pe_viscount_s	Missing	['dark_mercy_star_defender.alo', 'new_alderaan_defender.alo', 'rv_salvator.alo', 'rv_viscount_class_star_defender.alo', 'viscount.alo']
pe_imperial-class_engines_large	Missing	['dominator_i-class_star_destroyer.alo', 'ev_conqueror.alo', 'himera_star_destroyer.alo', 'imperial_i-class_star_destroyer.alo', 'imperial_ii-class_star_destroyer.alo', 'imperial_ii-class_star_destroyer_black.alo', 'tector_star_destroyer.alo', 'xyston_destroyer.alo', 'xyston_destroyerii.alo']
pte_imperial-class_engines_large	Missing	['dominator_i-class_star_destroyer.alo', 'ev_conqueror.alo', 'himera_star_destroyer.alo', 'imperial_i-class_star_destroyer.alo', 'imperial_ii-class_star_destroyer.alo', 'imperial_ii-class_star_destroyer_black.alo', 'xyston_destroyer.alo', 'xyston_destroyerii.alo']
pte_imperial-class_engines_small	Missing	['dominator_i-class_star_destroyer.alo', 'ev_conqueror.alo', 'himera_star_destroyer.alo', 'imperial_i-class_star_destroyer.alo', 'imperial_ii-class_star_destroyer.alo', 'imperial_ii-class_star_destroyer_black.alo', 'xyston_destroyer.alo', 'xyston_destroyerii.alo']
pptw_ptwsa	Missing	['dominator_i-class_star_destroyer.alo', 'ev_titan_ssd.alo', 'ev_venator.alo', 'ev_victorystardestroyer.alo', 'f_carrack.alo', 'f_munificent.alo', 'f_recusant.alo', 'f_titan.alo', 'f_victoryii.alo', 'himera_star_destroyer.alo', 'imperial_i-class_star_destroyer.alo', 'imperial_ii-class_star_destroyer.alo', 'imperial_ii-class_star_destroyer_black.alo', 'munificent.alo', 'recusant.alo', 'rv_moncalcruiser.alo', 'tector_star_destroyer.alo', 'titan_star_destroyer.alo', 'uv_invencible.alo', 'venator-class_star_destroyer.alo', 'venator_star_destroyer.alo', 'victoryii.alo', 'xyston_destroyer.alo', 'xyston_destroyerii.alo']
pgw_grav_well	Missing	['dominator_i-class_star_destroyer.alo', 'empire_dominator_star_destroyer.alo', 'ev_immobilizer.alo']
pptw_ptwsa2	Missing	['dreadnoughtiv.alo', 'evfo_onager.alo', 'ev_acclamator_assault_ship.alo', 'interceptoriv.alo', 'onager_star_destroyer.alo', 'uv_interceptoriv.alo']
pe_implacable_sml	Missing	['dreadnoughtiv.alo']
p_hp_imperial_damage	Missing	['dreadnoughtiv.alo', 'evfo_onager.alo', 'evfo_onager_d.alo', 'ev_allegiance_d.alo', 'ev_assertor_ssd.alo', 'ev_bellator.alo', 'ev_gladiator.alo', 'ev_resurgent.alo', 'ev_resurgent_d.alo', 'ev_secutor.alo', 'ev_secutor_t_turbo_db_prop.alo', 'ev_stardestroyer.alo', 'ev_stardestroyer_thrawn_d.alo', 'ev_victorystardestroyer.alo', 'mc80wingless.alo', 'rvre_starhawk.alo', 'rvre_starhawk_d.alo', 'rvre_vigil.alo', 'rv_mc108.alo', 'rv_mc112.alo', 'rv_mc80ajm.alo', 'rv_mc80wl.alo', 'rv_mc85.alo', 'rv_mediator.alo', 'uv_invencible.alo', 'w_kuat_ring_new_part02.alo', 'w_kuat_ring_new_part03.alo', 'w_kuat_ring_new_part04.alo', 'w_kuat_ring_new_part05.alo', 'w_planet_kuat.alo']
p_imperial_explosion_big00	Missing	['dreadnought_d.alo', 'evfo_onager_d.alo', 'ev_acclamator_assault_ship_d.alo', 'ev_allegiance_d.alo', 'ev_enforcership_d.alo', 'ev_resurgent_d.alo', 'ev_stardestroyer_thrawn_d.alo', 'ev_victorystardestroyer_d.alo', 'f_dreadnought_d.alo', 'f_imp_hero_d.alo', 'f_independence_d.alo', 'f_lucrehulk_d.alo', 'f_mc104_d.alo', 'f_mc40b_d.alo', 'f_mc50_d.alo', 'f_mc60_d.alo', 'f_mc75_d.alo', 'f_mc80a_d.alo', 'f_mc80b_d.alo', 'f_mc80c_d.alo', 'f_mc85_d.alo', 'f_mc90_d.alo', 'f_providence_d.alo', 'f_recusant_d.alo', 'f_strident_d.alo', 'f_thrawnsd_d.alo', 'f_titan_d.alo', 'f_victory_d.alo', 'rejuvenatorsd_d.alo', 'rvre_starhawk_d.alo', 'rv_mc80ajm_d.alo', 'rv_mediator_d.alo', 'uv_eclipse_d.alo', 'uv_invencible_d.alo']
p_imperial_midshipsmoke00	Missing	['dreadnought_d.alo']
p_boba_jetpack	Missing	['ei_bobafett.alo', 'mi_death_watch_lieutenant.alo']
p_flamethrower00	Missing	['ei_bobafett.alo', 'mi_death_watch_lieutenant.alo']
p_dark_jetpack	Missing	['ei_darktrooper.alo']
p_flamethrower00b	Missing	['ei_darktrooper.alo']
p_telekenesis	Missing	['ei_vader.alo']
p_bladecrash	Missing	['ei_vader.alo']
pgw_interdict_fx	Missing	['empire_dominator_star_destroyer.alo']
pe_imperial_star_destroyer_large	Missing	['empire_dominator_star_destroyer.alo']
pe_imperial_star_destroyer_small	Missing	['empire_dominator_star_destroyer.alo']
p_ship_fire	Missing	['empire_dominator_star_destroyer.alo']
p_ship_fire_explosion	Missing	['empire_dominator_star_destroyer.alo', 'empire_shieldgate_lvl1.alo', 'empire_shieldgate_lvl2.alo', 'empire_shieldgate_lvl3.alo', 'empire_shieldgate_lvl4.alo', 'empire_shieldgate_lvl5.alo']
p_ship_fire_small_explosion	Missing	['empire_dominator_star_destroyer.alo', 'empire_immobilizer_418.alo', 'empire_shieldgate_lvl1.alo', 'empire_shieldgate_lvl2.alo', 'empire_shieldgate_lvl3.alo', 'empire_shieldgate_lvl4.alo', 'empire_shieldgate_lvl5.alo', 'empire_vindicator.alo']
p_ship_fire_very_small_explosion	Missing	['empire_dominator_star_destroyer.alo', 'empire_immobilizer_418.alo', 'empire_shieldgate_lvl1.alo', 'empire_shieldgate_lvl2.alo', 'empire_shieldgate_lvl3.alo', 'empire_shieldgate_lvl4.alo', 'empire_shieldgate_lvl5.alo', 'empire_vindicator.alo']
pf_small_w	Missing	['empire_dominator_star_destroyer.alo', 'empire_immobilizer_418.alo', 'empire_shieldgate_lvl1.alo', 'empire_shieldgate_lvl2.alo', 'empire_shieldgate_lvl3.alo', 'empire_shieldgate_lvl4.alo', 'empire_shieldgate_lvl5.alo', 'empire_vindicator.alo']
pe_vindicator_l	Missing	['empire_immobilizer_418.alo', 'empire_vindicator.alo']
pe_vindicator_s	Missing	['empire_immobilizer_418.alo', 'empire_vindicator.alo']
pf_small_y	Missing	['empire_immobilizer_418.alo', 'empire_vindicator.alo']
pd_medium_3_150	Missing	['empire_immobilizer_418.alo', 'empire_vindicator.alo']
pgw_grav_well_immobilizer	Missing	['empire_immobilizer_418.alo']
pe_tie	Missing	['empire_tie_striker.alo']
p_atat_die	Missing	['evfo_atat.alo', 'ev_at-at.alo', 'ev_atact.alo']
p_explosion_empire_atat00	Missing	['evfo_atat.alo', 'ev_at-at.alo', 'ev_atact.alo', 'rv_attack_tank_d.alo', 'rv_t12b_d.alo', 'rv_tb10_d.alo']
p_smoke_tiny_atat	Missing	['evfo_atat.alo', 'ev_at-at.alo', 'ev_atact.alo']
p_explosion_chain_atat	Missing	['evfo_atat.alo', 'ev_at-at.alo', 'ev_atact.alo']
p_hp_alliancex3	Missing	['evfo_onager.alo', 'evfo_onager_d.alo', 'ev_acclamator_assault_ship.alo', 'ev_enforcership.alo', 'ev_gladiator.alo', 'mc80wingless.alo', 'rvre_starhawk.alo', 'rvre_starhawk_d.alo', 'rvre_vigil.alo', 'rv_assault_frigatemkiiix.alo', 'rv_mc80ajm.alo', 'rv_mc85.alo', 'vindicator.alo']
pe_engine_w15	Missing	['evfo_onager.alo', 'onager_star_destroyer.alo']
pe_engine_w10	Missing	['evfo_onager.alo', 'onager_star_destroyer.alo']
p_explosion_chain5e	Missing	['evfo_onager_d.alo']
p_explosion_chain13	Missing	['evfo_onager_d.alo', 'ev_assertor_ssd_d.alo', 'ev_bellator_d.alo', 'rv_mc108_d.alo']
p_imperial_explosion_small00	Missing	['evfo_onager_d.alo', 'ev_resurgent_d.alo', 'ev_stardestroyer_thrawn_d.alo']
p_explosion_chain13e	Missing	['evfo_onager_d.alo']
p_explosion_deathclonex4_big	Missing	['evfo_onager_d.alo', 'rv_mc108_d.alo']
p_explosion_chain16	Missing	['evfo_onager_d.alo', 'rvre_starhawk_d.alo']
p_explosion_chain17	Missing	['evfo_onager_d.alo', 'rvre_starhawk_d.alo']
p_explosion_chain18	Missing	['evfo_onager_d.alo', 'rvre_starhawk_d.alo']
p_imperial_explosion_huge00	Missing	['evfo_onager_d.alo', 'ev_allegiance_d.alo', 'ev_enforcership_d.alo', 'ev_gladiator_d.alo', 'ev_resurgent_d.alo', 'ev_stardestroyer_thrawn_d.alo', 'f_dreadnought_d.alo', 'f_imp_hero_d.alo', 'f_independence_d.alo', 'f_lucrehulk_d.alo', 'f_mc104_d.alo', 'f_mc40b_d.alo', 'f_mc50_d.alo', 'f_mc60_d.alo', 'f_mc80a_d.alo', 'f_mc80b_d.alo', 'f_mc80c_d.alo', 'f_mc85_d.alo', 'f_mc90_d.alo', 'f_providence_d.alo', 'f_recusant_d.alo', 'f_strident_d.alo', 'f_thrawnsd_d.alo', 'f_titan_d.alo', 'f_victory_d.alo', 'rvre_starhawk_d.alo', 'rv_mc108_d.alo', 'rv_mc112_d.alo', 'rv_mc80ajm_d.alo', 'rv_mediator_d.alo', 'uv_invencible_d.alo']
p_explosion_chain18e	Missing	['evfo_onager_d.alo', 'rvre_starhawk_d.alo']
p_smoketrail01	Missing	['evfo_onager_d.alo', 'ev_resurgent_d.alo', 'ev_stardestroyer_thrawn_d.alo', 'rv_mc85_d.alo']
p_explosion_chain16e	Missing	['evfo_onager_d.alo', 'rvre_starhawk_d.alo']
pte_acclamatorfalse	Missing	['ev_acclamator_assault_ship.alo']
pe_acclamatorengines	Missing	['ev_acclamator_assault_ship.alo']
pe_tartanengine_lrg	Missing	['ev_acclamator_assault_ship.alo']
pte_aclamatormkii	Missing	['ev_acclamator_assault_ship.alo']
p_weapon_c_blinkblue	Missing	['ev_acclamator_assault_ship.alo']
p_imperial_midshipsmo14	Missing	['ev_acclamator_assault_ship_d.alo', 'ev_bellator_d.alo']
p_imperial_midshipsmo12	Missing	['ev_acclamator_assault_ship_d.alo', 'rv_mc112_d.alo']
p_imperial_midshipsmo15	Missing	['ev_acclamator_assault_ship_d.alo', 'ev_bellator_d.alo', 'rv_mc85_d.alo']
p_imperial_midshipsmo13	Missing	['ev_acclamator_assault_ship_d.alo', 'ev_bellator_d.alo']
p_rebelsmokedea18	Missing	['ev_acclamator_assault_ship_d.alo', 'ev_assertor_ssd_d.alo', 'rv_mc80ajm_d.alo']
p_imperial_midshipsmo03	Missing	['ev_acclamator_assault_ship_d.alo', 'uv_invencible_d.alo']
p_debris01	Missing	['ev_acclamator_assault_ship_d.alo', 'ev_enforcership_d.alo', 'ev_gladiator_d.alo', 'ev_victorystardestroyer_d.alo', 'rv_mc80ajm_d.alo', 'rv_mediator_d.alo', 'uv_interceptoriv_d.alo', 'w_kuat_ring_new_part07_d.alo']
p_fire_empire_big00	Missing	['ev_acclamator_assault_ship_d.alo', 'ev_allegiance_d.alo', 'ev_enforcership_d.alo', 'ev_victory1_death.alo', 'f_dreadnought_d.alo', 'f_imp_hero_d.alo', 'f_independence_d.alo', 'f_lucrehulk_d.alo', 'f_mc104_d.alo', 'f_mc40b_d.alo', 'f_mc50_d.alo', 'f_mc60_d.alo', 'f_mc80a_d.alo', 'f_mc80b_d.alo', 'f_mc80c_d.alo', 'f_mc85_d.alo', 'f_mc90_d.alo', 'f_providence_d.alo', 'f_recusant_d.alo', 'f_strident_d.alo', 'f_thrawnsd_d.alo', 'f_titan_d.alo', 'f_victory_d.alo', 'rejuvenatorsd_d.alo', 'rvre_starhawk_d.alo', 'rv_mc108_d.alo', 'rv_mc112_d.alo', 'rv_mc80ajm_d.alo', 'rv_mediator_d.alo']
p_girder_sparks01	Missing	['ev_acclamator_assault_ship_d.alo', 'w_kuat_ring_new_part07_d.alo']
p_rebelsmokedea19	Missing	['ev_acclamator_assault_ship_d.alo', 'ev_assertor_ssd_d.alo', 'ev_enforcership_d.alo']
pe_jedicruiser_lrg	Missing	['ev_allegiance.alo', 'ev_venator.alo', 'f_mc90b.alo', 'f_strident.alo', 'mc90b_star_destroyer.alo', 'strident_gold_star_destroyer.alo', 'strident_star_destroyer.alo']
pe_allegiance	Missing	['ev_allegiance.alo']
p_explosion_krayt	Missing	['ev_allegiance_d.alo']
p_underworldbardeath	Missing	['ev_allegiance_d.alo']
p_explosion_chain4	Missing	['ev_allegiance_d.alo', 'rvre_vigil_d.alo', 'w_kuat_ring_new_part02_d.alo', 'w_kuat_ring_new_part03_d.alo', 'w_kuat_ring_new_part04_d.alo', 'w_kuat_ring_new_part05_d.alo']
p_imperial_midshipsmo06	Missing	['ev_allegiance_d.alo']
p_rebelsmokedea10	Missing	['ev_allegiance_d.alo', 'ev_bellator_d.alo']
p_imperial_midshipsmo20	Missing	['ev_allegiance_d.alo', 'ev_assertor_ssd_d.alo']
p_rebelsmokedea05	Missing	['ev_allegiance_d.alo', 'ev_gladiator_d.alo']
p_explosion_blast02_delay	Missing	['ev_allegiance_d.alo']
p_imperial_midshipsmo10	Missing	['ev_allegiance_d.alo', 'ev_bellator_d.alo']
p_explosion_chain5	Missing	['ev_allegiance_d.alo', 'ev_assertor_ssd_d.alo', 'ev_bellator_d.alo', 'rvre_vigil_d.alo', 'rv_mc108_d.alo']
p_rebelsmokedea11	Missing	['ev_allegiance_d.alo', 'ev_bellator_d.alo']
p_rebelsmokedea20	Missing	['ev_allegiance_d.alo', 'ev_assertor_ssd_d.alo']
p_hp_imperial_damage02	Missing	['ev_assertor_ssd.alo']
p_hp_alliancex4	Missing	['ev_assertor_ssd.alo', 'ev_bellator.alo', 'ev_secutor.alo']
p_explosion_chain7	Missing	['ev_assertor_ssd_d.alo', 'ev_bellator_d.alo', 'rvre_vigil_d.alo', 'rv_mc108_d.alo']
p_explosion_chain8	Missing	['ev_assertor_ssd_d.alo', 'ev_bellator_d.alo', 'rv_mc108_d.alo']
p_explosion_chain10	Missing	['ev_assertor_ssd_d.alo', 'ev_bellator_d.alo', 'rv_mc108_d.alo']
p_explosion_chain12	Missing	['ev_assertor_ssd_d.alo', 'ev_bellator_d.alo', 'rv_mc108_d.alo']
p_explosion_chain11	Missing	['ev_assertor_ssd_d.alo', 'ev_bellator_d.alo', 'rv_mc108_d.alo']
p_explosion_chain9	Missing	['ev_assertor_ssd_d.alo', 'ev_bellator_d.alo', 'rv_mc108_d.alo']
p_explosion_deathclonex1_huge	Missing	['ev_assertor_ssd_d.alo', 'ev_bellator_d.alo']
p_explosion_deathclonex2_huge	Missing	['ev_assertor_ssd_d.alo', 'ev_bellator_d.alo']
p_explosion_deathclonex3_huge	Missing	['ev_assertor_ssd_d.alo', 'ev_bellator_d.alo']
p_explosion_deathclonex4_huge	Missing	['ev_assertor_ssd_d.alo', 'ev_bellator_d.alo']
p_explosion_chain6	Missing	['ev_assertor_ssd_d.alo', 'ev_bellator_d.alo', 'rv_mc108_d.alo']
p_explosion_empire_friggin_huge00	Missing	['ev_assertor_ssd_d.alo', 'ev_bellator_d.alo', 'ev_victory1_death.alo', 'rv_mc85_d.alo', 'w_kuat_ring_new_part07_d.alo']
p_explosion_chain14	Missing	['ev_assertor_ssd_d.alo', 'ev_bellator_d.alo', 'rv_mc108_d.alo']
p_explosion_ssd	Missing	['ev_assertor_ssd_d.alo', 'ev_bellator_d.alo', 'ev_empress_d.alo', 'ev_executorstardestroyer_d.alo']
p_imperial_midshipsmo19	Missing	['ev_assertor_ssd_d.alo', 'ev_enforcership_d.alo']
p_ssd_bigexplode00	Missing	['ev_assertor_ssd_d.alo', 'ev_bellator_d.alo', 'ev_empress_d.alo', 'ev_executorstardestroyer_d.alo']
p_ssd_endexplosion	Missing	['ev_assertor_ssd_d.alo', 'ev_bellator_d.alo', 'ev_empress_d.alo', 'ev_executorstardestroyer_d.alo']
p_ssd_firesmokebar	Missing	['ev_assertor_ssd_d.alo', 'ev_bellator_d.alo', 'ev_empress_d.alo', 'ev_executorstardestroyer_d.alo']
p_atst_die	Missing	['ev_at_dt.alo', 'ev_at_mp.alo', 'nv_podwalker.alo', 'rev_atpt.alo', 'rv_aac2_d.alo', 'rv_t2b-aav_d.alo', 'rv_t5bx_d.alo', 'rv_t6bx_d.alo', 'rv_t8bx_d.alo']
p_fire_small01	Missing	['ev_at_dt.alo', 'ev_at_mp.alo', 'nv_podwalker.alo', 'rev_atpt.alo', 'rv_aac2_d.alo', 'rv_t2b-aav_d.alo', 'rv_t5bx_d.alo', 'rv_t6bx_d.alo', 'rv_t8bx_d.alo']
pe_engine_b55	Missing	['ev_bellator.alo']
pe_engine_b12	Missing	['ev_bellator.alo']
p_imperial_midshipsmo09	Missing	['ev_bellator_d.alo']
p_rebelsmokedea09	Missing	['ev_bellator_d.alo']
p_fire_small00	Missing	['ev_century_tank_d.alo']
p_planet_deathstar_laser_small	Missing	['ev_conqueror.alo', 'w_planet_deathstar.alo']
pe_raider_l	Missing	['ev_corvus.alo', 'raider_corvette.alo']
pe_raider_s	Missing	['ev_corvus.alo', 'raider_corvette.alo']
pte_raider_l	Missing	['ev_corvus.alo', 'raider_corvette.alo']
pte_raider_s	Missing	['ev_corvus.alo', 'raider_corvette.alo']
pe_dominion_large	Missing	['ev_dominion.alo']
pe_dominion_small	Missing	['ev_dominion.alo']
p_heat_glow	Missing	['ev_eclipse.alo', 'uv_eclipse.alo']
lookat	Missing	['ev_eclipse.alo', 'uv_eclipse.alo']
p_eclipse_chargeleft2	Missing	['ev_eclipse.alo', 'uv_eclipse.alo']
p_eclipse_chargeright	Missing	['ev_eclipse.alo', 'uv_eclipse.alo']
p_green_rings3	Missing	['ev_eclipse.alo', 'uv_eclipse.alo']
p_green_flash2	Missing	['ev_eclipse.alo', 'uv_eclipse.alo']
p_hp_ssd-damage	Missing	['ev_empress_d.alo', 'ev_executorstardestroyer_d.alo', 'uv_eclipse_d.alo']
p_ssd_firesmokebar_med	Missing	['ev_empress_d.alo', 'ev_executorstardestroyer_d.alo', 'rev_mandator_d.alo', 'rv_mc108_d.alo', 'rv_mc112_d.alo']
p_ssd_firesmokebar_sml	Missing	['ev_empress_d.alo', 'ev_executorstardestroyer_d.alo', 'ev_resurgent_d.alo', 'rev_mandator_d.alo']
pe_jedicruiser_sml	Missing	['ev_enforcership.alo', 'ev_venator.alo', 'f_dauntless.alo', 'f_mc40.alo', 'f_mc75.alo', 'f_nebulonb.alo', 'f_nebulonb2.alo', 'mc40.alo', 'mc60.alo', 'mc75.alo', 'raddus_star_cruiser.alo', 're_raddus.alo', 'rvre_raddus.alo', 'vindicator.alo']
pte_nebulonb2	Missing	['ev_gladiator.alo', 'rv_assault_frigatemkiiix.alo']
pe_engine_v20	Missing	['ev_gladiator.alo']
p_imperial_explosion_big03	Missing	['ev_gladiator_d.alo']
p_imperial_explosion_big04	Missing	['ev_gladiator_d.alo']
p_explosion_empire_big02	Missing	['ev_gladiator_d.alo']
p_imperial_midshipsm05	Missing	['ev_gladiator_d.alo']
pptw_2mtank	Missing	['ev_iftx.alo', 'ev_tx_tank.alo', 'hu_hvy_sail_barge.alo', 'hu_multi_skiff.alo', 'rv_t6bx.alo', 'rv_t6bxx.alo', 'rv_v19_landspeeder.alo']
pi_damage_elec_cap00	Missing	['ev_immobilizer.alo', 'interceptoriv.alo', 'uv_interceptoriv.alo']
p_hp_underworld_damage	Missing	['ev_immobilizer.alo', 'ev_quasar_d.alo', 'finalizer_sd.alo', 'hutt_cruiser.alo', 'hutt_cruiser_d.alo', 'interceptoriv.alo', 'kraytclassdestroyer.alo', 'mv_kandosii.alo', 'nv_jovan_station.alo', 'nv_jovan_station_d.alo', 'profundity.alo', 'profundity_d.alo', 'reb_quasar_sato.alo', 'reb_quasar_sato_d.alo', 'rep_light_cruiser.alo', 'rv_quasar_sato.alo', 'rv_quasar_sato_d.alo', 'uv_interceptoriv.alo', 'uv_nebulon_c.alo', 'uv_nebulon_c_d.alo']
prs_interdict_fx	Missing	['ev_immobilizer.alo']
pe_imperialcraftengine	Missing	['ev_imperialcraft.alo', 'ev_imperialcraft_loader.alo', 'ev_imperialcraft_loader_space.alo', 'ev_imperialcraft_space.alo']
p_hp_alliancex10	Missing	['ev_resurgent.alo', 'ev_resurgent_d.alo']
pe_relentless	Missing	['ev_resurgent.alo']
p_hp_alliancex11	Missing	['ev_resurgent_d.alo']
p_firesmoke00	Missing	['ev_resurgent_d.alo', 'ev_stardestroyer_thrawn_d.alo', 'rv_mc108_d.alo', 'rv_mc112_d.alo', 'rv_mc85_d.alo', 'rv_mediator_cruiser_d.alo']
pe_predatorsml	Missing	['ev_secutor.alo', 'raddus_star_cruiser.alo', 're_raddus.alo', 'rvre_raddus.alo', 'rv_mc85.alo']
pte_blue_diver_sml	Missing	['ev_secutor.alo']
pe_predator	Missing	['ev_secutor.alo', 'rv_mc85.alo']
pte_mc85	Missing	['ev_secutor.alo', 'raddus_star_cruiser.alo', 're_raddus.alo', 'rvre_raddus.alo']
pe_stardestroyerengines	Missing	['ev_stardestroyer.alo']
p_weapon_charged	Missing	['ev_titan_ssd.alo', 'f_mc90b.alo', 'f_titan.alo', 'mc90b_star_destroyer.alo', 'titan_star_destroyer.alo']
pe_turbulent_small	Missing	['ev_turbulent.alo', 'turbulent_star_destroyer.alo']
pe_turbulent_large	Missing	['ev_turbulent.alo', 'turbulent_star_destroyer.alo']
hp_m-c_emitdamage	Missing	['ev_venator.alo']
hp_e_mainengines	Missing	['ev_venator.alo']
hp_turret_1l_emitdamage	Missing	['ev_venator.alo']
hp_turret_1r_emitdamage	Missing	['ev_venator.alo']
hp_turret_2l_emitdamage	Missing	['ev_venator.alo']
hp_turret_3l_emitdamage	Missing	['ev_venator.alo']
hp_turret_4l_emitdamage	Missing	['ev_venator.alo']
hp_turret_4r_emitdamage	Missing	['ev_venator.alo']
hp_turret_3r_emitdamage	Missing	['ev_venator.alo']
hp_turret_2r_emitdamage	Missing	['ev_venator.alo']
p_blank_blank	Missing	['ev_victory1.alo']
p_blank_blank__	Missing	['ev_victory1.alo']
p_explosion_huge02_e	Missing	['ev_victory1_death.alo', 'nv_jovan_station.alo', 'rep_starbase_level_01.alo', 'rep_starbase_level_01_d.alo', 'rep_starbase_level_02.alo', 'rep_starbase_level_02_d.alo', 'rep_starbase_level_03.alo', 'rep_starbase_level_03_d.alo', 'rep_starbase_level_04.alo', 'rep_starbase_level_04_d.alo', 'rep_starbase_level_05.alo', 'rep_starbase_level_05_d.alo', 'w_kuat_ring_new_part06_d.alo']
pe_victoryengines	Missing	['ev_victorystardestroyer.alo', 'icon_ev_victorystardestroyer.alo']
p_hp_underworld_damage_lrg	Missing	['familybase_01.alo', 'familybase_01_d.alo', 'familybase_02.alo', 'familybase_02_d.alo', 'familybase_03.alo', 'familybase_03_d.alo', 'familybase_04.alo', 'familybase_04_d.alo', 'familybase_05.alo', 'familybase_05_d.alo', 'kedalbebattleship.alo', 'nv_jovan_station.alo', 'nv_jovan_station_d.alo', 'salvator_d.alo', 'uv_kedalbebattleship.alo', 'viscount.alo', 'viscount_d.alo']
p_u_light_throb	Missing	['familybase_01.alo', 'familybase_02.alo', 'familybase_03.alo', 'familybase_04.alo', 'familybase_05.alo', 'nb_sluis_van.alo', 'nb_the_wheel.alo']
p_rebcapdestroy_shrt	Missing	['familybase_01_d.alo', 'familybase_02_d.alo', 'familybase_03_d.alo', 'familybase_04_d.alo', 'familybase_05_d.alo', 'rev_mandator_d.alo']
pe_finalizer_s	Missing	['finalizer_sd.alo']
pe_finalizer_l	Missing	['finalizer_sd.alo']
pe_freefall	Missing	['freefall.alo']
pe_dreadnought00	Missing	['f_dreadnought.alo']
p_exp_flsh_00	Missing	['f_dreadnought_d.alo', 'f_imp_hero_d.alo', 'f_independence_d.alo', 'f_lucrehulk_d.alo', 'f_mc104_d.alo', 'f_mc40b_d.alo', 'f_mc50_d.alo', 'f_mc60_d.alo', 'f_mc75_d.alo', 'f_mc80a_d.alo', 'f_mc80b_d.alo', 'f_mc80c_d.alo', 'f_mc85_d.alo', 'f_mc90_d.alo', 'f_providence_d.alo', 'f_recusant_d.alo', 'f_strident_d.alo', 'f_thrawnsd_d.alo', 'f_titan_d.alo', 'f_victory_d.alo', 'rejuvenatorsd_d.alo', 'rv_mc80ajm_d.alo']
p_rebelsmokedeath	Missing	['f_dreadnought_d.alo', 'f_imp_hero_d.alo', 'f_independence_d.alo', 'f_lucrehulk_d.alo', 'f_mc104_d.alo', 'f_mc40b_d.alo', 'f_mc50_d.alo', 'f_mc60_d.alo', 'f_mc75_d.alo', 'f_mc80a_d.alo', 'f_mc80b_d.alo', 'f_mc80c_d.alo', 'f_mc85_d.alo', 'f_mc90_d.alo', 'f_providence_d.alo', 'f_recusant_d.alo', 'f_strident_d.alo', 'f_thrawnsd_d.alo', 'f_titan_d.alo', 'f_victory_d.alo', 'rejuvenatorsd_d.alo', 'rv_mc108_d.alo', 'rv_mc112_d.alo', 'rv_mediator_d.alo', 'uv_invencible_d.alo']
p_explosion_blast01_delay	Missing	['f_imp_hero_d.alo', 'f_independence_d.alo', 'f_mc104_d.alo', 'f_mc85_d.alo', 'f_mc90_d.alo', 'f_strident_d.alo', 'f_thrawnsd_d.alo', 'f_titan_d.alo', 'rejuvenatorsd_d.alo', 'rv_mc85_d.alo', 'uv_invencible_d.alo']
p_explosion_thermal_empire	Missing	['f_imp_hero_d.alo', 'f_independence_d.alo', 'f_mc104_d.alo', 'f_mc85_d.alo', 'f_mc90_d.alo', 'f_strident_d.alo', 'f_thrawnsd_d.alo', 'f_titan_d.alo', 'rejuvenatorsd_d.alo', 'rv_mediator_d.alo']
pe_interdictorengine_sml	Missing	['f_liberator.alo', 'reb_quasar_sato.alo', 'rv_quasar_sato.alo']
pe_mc90_cruiser_en	Missing	['f_mc90.alo', 'mc90_star_destroyer.alo']
pe_corvetteengines	Missing	['f_munificent.alo', 'hvycruiser3.alo', 'munificent.alo', 'uv_nebulon_c.alo']
p_smoke_jug_small	Missing	['gargantuan_advanced.alo', 'rv_t12b.alo', 'rv_tb10.alo']
p_smoke_jug	Missing	['gargantuan_advanced.alo', 'rv_t12b.alo', 'rv_tb10.alo']
p_garg_dust	Missing	['gargantuan_advanced.alo', 'rv_attack_tank.alo']
pe_gauntlet	Missing	['gauntlet.alo']
pe_gozanti_l	Missing	['gozanti.alo', 'gozanti_black_sun.alo', 'gozanti_empire.alo', 'gozanti_empire_01.alo', 'gozanti_empire_02.alo']
pe_gozanti_s	Missing	['gozanti.alo', 'gozanti_black_sun.alo', 'gozanti_empire.alo', 'gozanti_empire_01.alo', 'gozanti_empire_02.alo']
pe_hammerhead_corvette	Missing	['hammerhead_corvette.alo']
pe_havoc_lrg	Missing	['havoc.alo']
pe_havoc_sml	Missing	['havoc.alo']
pe_hutt_cruiser	Missing	['hutt_cruiser.alo']
pe_hutt_dagger_engine01	Missing	['hutt_dagger.alo']
pe_hutt_dagger_engine02	Missing	['hutt_dagger.alo']
pe_awingenginesland	Missing	['hu_pirate_speeder_2.alo']
pte_awingenginesland	Missing	['hu_pirate_speeder_2.alo']
pte_corvetteengines	Missing	['hvycruiser3.alo', 'uv_nebulon_c.alo']
pe_pelleaon_02	Missing	['imperious.alo', 'pelleaon.alo', 'pelleaon_star_destroyer.alo']
pe_pelleaon_01	Missing	['imperious.alo', 'pelleaon.alo', 'pelleaon_star_destroyer.alo']
p_explosion_chain5_e	Missing	['imperious_d.alo', 'pelleaon_d.alo', 'rep_starbase_level_03_d.alo', 'rep_starbase_level_04_d.alo', 'rep_starbase_level_05_d.alo', 'w_kuat_ring_new_part06_d.alo']
p_explosion_empire_huge00	Missing	['imperious_d.alo', 'pelleaon_d.alo', 'rev_mandator_d.alo', 'w_kuat_ring_new_part07_d.alo']
p_explosion_empire_big00	Missing	['imperious_d.alo', 'pelleaon_d.alo']
pe_interceptorengine	Missing	['interceptoriv.alo', 'uv_interceptoriv.alo', 'uv_interceptoriv_cine.alo']
p_rb_stationblink_tiny	Missing	['i_cis_station_level1.alo', 'i_cis_station_level2.alo', 'i_cis_station_level3.alo', 'i_cis_station_level4.alo', 'i_cis_station_level5.alo']
p_keldabeengine	Missing	['kedalbebattleship.alo', 'uv_kedalbebattleship.alo']
pptw_power_to_weapons	Missing	['kedalbebattleship.alo', 'uv_kedalbebattleship.alo']
pe_kraytclassengines_sml	Missing	['kraytclassdestroyer.alo']
pe_kraytclassengines_lrg	Missing	['kraytclassdestroyer.alo']
pe_mandalorian_cruiser	Missing	['mandalorian_cruiser1.alo', 'mandalorian_cruiser2.alo']
p_smoke_small02	Missing	['mandalorian_speeder.alo']
pi_damage_elec_frigate	Missing	['mc30_ardent-class_frigate.alo']
pe_ardent-class_engines_medium	Missing	['mc30_ardent-class_frigate.alo']
pe_ardent-class_engines_small	Missing	['mc30_ardent-class_frigate.alo']
pe_ardent-class_engine_large	Missing	['mc30_ardent-class_frigate.alo']
pe_mc40_cruiser_en	Missing	['mc40b.alo']
pe_mc80b_cruiser__	Missing	['mc80b.alo', 'mc80c.alo']
pptw_power_to_weapons6	Missing	['mc80wingless.alo', 'mc80_wingless.alo', 'rv_mc80ajm.alo', 'rv_mc80wl.alo']
pe_engine_w20	Missing	['mc80wingless.alo', 'mc80_wingless.alo', 'rvre_starhawk.alo', 'rv_mc80ajm.alo', 'rv_mc80wl.alo']
pte_victory2	Missing	['mc80wingless.alo', 'mc80_wingless.alo', 'rv_mc80ajm.alo', 'rv_mc80wl.alo', 'uv_invencible.alo']
pe_mc80ho_cruiser_	Missing	['mc80_home_one.alo', 'rv_home_one.alo']
pe_mediator	Missing	['mediator_dreadnaught.alo', 'rv_mediator.alo', 'rv_mediator_battlecruiser.alo']
pi_damage_elec_sd01	Missing	['mv_kandosii.alo']
p_hp_smoke_damage_00	Missing	['mv_kandosii.alo']
pe_kandosii_sml_05	Missing	['mv_kandosii.alo']
pe_kandosii_sml_04	Missing	['mv_kandosii.alo']
pe_kandosii_sml_03	Missing	['mv_kandosii.alo']
pe_kandosii_lrg_00	Missing	['mv_kandosii.alo']
p_hp_small_fire_damage	Missing	['mv_kandosii.alo']
pe_kandosii_sml_00	Missing	['mv_kandosii.alo']
pe_kandosii_sml_01	Missing	['mv_kandosii.alo']
pe_kandosii_sml_02	Missing	['mv_kandosii.alo']
pe_kandosii_lrg_01	Missing	['mv_kandosii.alo']
p_smoke_small01	Missing	['nb_black_sun_bmphq.alo', 'rev_atpt.alo']
p_explosion_rck_desert_med03	Missing	['nb_black_sun_bmphq.alo']
p_smoke_tiny01	Missing	['nb_black_sun_bmphq.alo']
p_stealing02	Missing	['nb_black_sun_bmphq.alo']
p_fire_med00	Missing	['nv_dread_die.alo', 'rev_mandator.alo', 'rev_mandator_d.alo', 'rv_mandator.alo']
pptw_power_to_weapons4	Missing	['nv_jovan_station.alo']
p_blink_white_big	Missing	['nv_jovan_station.alo', 'rep_starbase_hp04_tbl_02.alo', 'rep_starbase_level_01.alo', 'rep_starbase_level_02.alo', 'rep_starbase_level_03.alo', 'rep_starbase_level_04.alo', 'rep_starbase_level_05.alo', 'starforge.alo', 'starforge_prop.alo']
p_ssd_chain00	Missing	['nv_jovan_station_d.alo', 'profundity_d.alo', 'salvator_d.alo', 'viscount_d.alo']
p_explosion_huge01	Missing	['nv_jovan_station_d.alo']
pe_vwingengines	Missing	['nv_vwing_republic.alo']
pe_pirate_speeder	Missing	['pirate_speeder.alo']
pe_profundity_l	Missing	['profundity.alo']
p_inf_flash_green	Missing	['proj_laser_green_inf.alo', 'proj_laser_yellow_f.alo', 'proj_vehicle_laser_green1.alo']
p_groundflash_red	Missing	['proj_laser_red_g.alo']
p_inf_flash_red	Missing	['proj_laser_red_inf.alo', 'proj_vehicle_laser_red1.alo']
p_fighterflash_blue	Missing	['proj_maser_blue_f.alo', 'proj_vehicle_laser_blue1.alo']
p_blue_beam	Missing	['p_blue_beam_grnd.alo']
pte_vsd	Missing	['raddus_star_cruiser.alo', 're_raddus.alo', 'rvre_raddus.alo']
pe_mc_mediator	Missing	['rebel_mon_calamari_mediator.alo']
pe_pelta	Missing	['reb_pelta_carrier.alo', 'rep_pelta.alo']
p_fire_big00	Missing	['reb_pelta_carrier_d.alo', 'rep_pelta_d.alo']
pi_damage_elec_capital	Missing	['reef_home-class_mc80_star_cruiser.alo', 'tector_star_destroyer.alo']
pe_reef_home-class_engines_large	Missing	['reef_home-class_mc80_star_cruiser.alo']
pe_reef_home-class_engines_medium	Missing	['reef_home-class_mc80_star_cruiser.alo']
pe_reef_home-class_engines_small	Missing	['reef_home-class_mc80_star_cruiser.alo']
pe_light_cruiser	Missing	['rep_light_cruiser.alo']
p_fire_billow3_e	Missing	['rep_starbase_level_01_d.alo', 'rep_starbase_level_02_d.alo', 'rep_starbase_level_03_d.alo', 'rep_starbase_level_04_d.alo', 'rep_starbase_level_05_d.alo', 'w_kuat_ring_new_part06_d.alo']
pe_mandator_s	Missing	['rev_mandator.alo', 'rv_mandator.alo']
pe_mandator_l	Missing	['rev_mandator.alo', 'rv_mandator.alo']
p_weapon_chargedr	Missing	['re_raddus.alo', 'rvre_raddus.alo', 'rv_mc112.alo']
pas_sprint	Missing	['ri_chewbacca.alo', 'ri_hansolo.alo']
p_urai_blade_sparks	Missing	['ri_rebel_jedi_ahsoka_tano.alo']
pe_engine_w45	Missing	['rvre_starhawk.alo']
pe_engine_w30	Missing	['rvre_starhawk.alo']
pe_engine_w6	Missing	['rvre_vigil.alo']
pte_engine_w6_false	Missing	['rvre_vigil.alo']
pe_engine_w3	Missing	['rvre_vigil.alo']
pte_engine_w1_5	Missing	['rvre_vigil.alo']
pe_engine_w1	Missing	['rvre_vigil.alo']
pte_engine_w1	Missing	['rvre_vigil.alo']
p_explosion_med08	Missing	['rv_aac2_d.alo']
p_explosion_med05	Missing	['rv_aac2_d.alo']
p_explosion_med04	Missing	['rv_aac2_d.alo']
p_explosion_med02	Missing	['rv_aac2_d.alo']
p_explosion_med03	Missing	['rv_aac2_d.alo', 'rv_t5bx_d.alo']
p_explosion_med06	Missing	['rv_aac2_d.alo']
p_explosion_med07	Missing	['rv_aac2_d.alo']
pptw_power_to_weapons2	Missing	['rv_assault_frigatemkiiix.alo']
pe_nebulonb2engine	Missing	['rv_assault_frigatemkiiix.alo']
pe_gunshipengine	Missing	['rv_assault_frigatemkiiix.alo']
pte_gunshipengine	Missing	['rv_assault_frigatemkiiix.alo']
p_hp_imperial_damages	Missing	['rv_assault_frigatemkiiix.alo']
p_smoke_big00	Missing	['rv_attack_tank.alo']
p_jug_dust	Missing	['rv_attack_tank.alo']
pe_mc112x2	Missing	['rv_mc108.alo', 'rv_mc112.alo']
pe_mc112x1	Missing	['rv_mc108.alo', 'rv_mc112.alo']
pe_mc112x3	Missing	['rv_mc108.alo', 'rv_mc112.alo']
p_explosion_deathclonex1_big	Missing	['rv_mc108_d.alo', 'rv_mc112_d.alo']
p_explosion_deathclonex3_big	Missing	['rv_mc108_d.alo', 'rv_mc112_d.alo']
p_explosion_deathclonex2_big	Missing	['rv_mc108_d.alo', 'rv_mc112_d.alo']
p_rebelsmokedea12	Missing	['rv_mc112_d.alo']
p_imperial_midshipsmo18	Missing	['rv_mc80ajm_d.alo']
pte_power_to_weapons6	Missing	['rv_mc85.alo']
p_rebelsmokedea15	Missing	['rv_mc85_d.alo']
p_underworlddeath	Missing	['rv_mc85_d.alo']
p_hp_alliancex3_death	Missing	['rv_mc85_d.alo']
p_explosion_small00	Missing	['rv_mediator_cruiser_d.alo']
pe_moncalengines	Missing	['rv_moncalcruiser.alo']
pe_moncalengines_sml	Missing	['rv_moncalcruiser.alo']
pe_moncalengines_mid	Missing	['rv_moncalcruiser.alo']
pptw_strike	Missing	['rv_snowspeeder.alo']
p_weapon_chargedggr	Missing	['rv_t12b.alo', 'rv_tb10.alo']
p_explosion_med21	Missing	['rv_t2b-aav_d.alo']
p_explosion_med20	Missing	['rv_t2b-aav_d.alo']
p_explosion_med19	Missing	['rv_t2b-aav_d.alo']
p_explosion_small07	Missing	['rv_t2b-aav_d.alo']
p_explosion_small02	Missing	['rv_t5bx_d.alo']
p_explosion_small04	Missing	['rv_t5bx_d.alo']
p_explosion_med00	Missing	['rv_t6bx_d.alo']
p_explosion_med09	Missing	['rv_t6bx_d.alo']
p_explosion_small08	Missing	['rv_t6bx_d.alo']
p_explosion_med16	Missing	['rv_t8bx_d.alo']
p_explosion_med15	Missing	['rv_t8bx_d.alo']
p_explosion_med17	Missing	['rv_t8bx_d.alo']
pte_u_wing	Missing	['rv_uwing.alo', 'rv_uwing_blue.alo', 'rv_uwing_landing.alo']
p_landing_dust	Missing	['rv_uwing_landing.alo']
p_explosion_friggin_huge00	Missing	['salvator_d.alo', 'starforge_d.alo', 'viscount_d.alo']
pe_z95engines	Missing	['sev_tridroid.alo']
pe_qf	Missing	['ss_quasarfire.alo']
ab_big_fire	Missing	['ss_quasarfire.alo']
ab_fire	Missing	['ss_quasarfire.alo']
ab_sm_fire	Missing	['ss_quasarfire.alo']
p_starforge	Missing	['starforge.alo']
p_planet_explode_300	Missing	['starforge_d.alo']
pe_imperial-class_engines_small	Missing	['tector_star_destroyer.alo']
p_neutralsmokedeath	Missing	['uv_interceptoriv_d.alo']
p_rebelsmokedea03	Missing	['uv_invencible_d.alo']
pe_vwing	Missing	['v-wing.alo']
pe_venator-class_engines_small	Missing	['venator-class_star_destroyer.alo', 'venator_star_destroyer.alo']
pe_venator-class_engines_large	Missing	['venator-class_star_destroyer.alo', 'venator_star_destroyer.alo']
pe_venator-class_engines_medium	Missing	['venator-class_star_destroyer.alo', 'venator_star_destroyer.alo']
p_orangelaserflash	Missing	['w_acc_missile.alo']
p_concussion_acc	Missing	['w_acc_missile.alo']
p_concussion	Missing	['w_adv_concussion_missiletie95gr.alo', 'w_concussion_missile.alo', 'w_concussion_missile_4c.alo']
p_black_hole_inner	Missing	['w_black_hole.alo']
p_concussion01	Missing	['w_concussion_missile_4c.alo']
p_concussion02	Missing	['w_concussion_missile_4c.alo']
p_concussion03	Missing	['w_concussion_missile_4c.alo']
p_concussion_ground_generic	Missing	['w_concussion_missile_ground_generic_white.alo']
p_rocket_glow_generic	Missing	['w_concussion_missile_ground_generic_white.alo']
p_thermal_trailb	Missing	['w_flack_podb.alo', 'w_flack_podb2.alo']
p_thermal_trailx	Missing	['w_flack_podx.alo']
p_thermal_trailx2	Missing	['w_flakm_proyectile.alo']
p_galaxycore	Missing	['w_galaxy00.alo']
p_planet_gc_map_planet	Missing	['w_gc_planet_alderaan.alo', 'w_gc_planet_bespin.alo', 'w_gc_planet_forest.alo', 'w_gc_planet_ice.alo', 'w_gc_planet_swamp.alo', 'w_gc_planet_taris.alo', 'w_gc_planet_temperate.alo', 'w_gc_planet_vulcanic.alo', 'w_gc_planet_wayland.alo', 'w_gc_planet_yaviniv.alo']
p_greenlaserflash	Missing	['w_greenlaser_largehvyx.alo']
p_fire_billow2	Missing	['w_kuat_ring_new_part02_d.alo', 'w_kuat_ring_new_part03_d.alo', 'w_kuat_ring_new_part04_d.alo', 'w_kuat_ring_new_part05_d.alo']
p_land_flak_missile	Missing	['w_land_flak_missile.alo']
p_rocket_motor	Missing	['w_land_rocket.alo']
p_redlaserflashs	Missing	['w_laserhvyredlandxf.alo']
p_aureola_laser_small_yellow	Missing	['w_laser_smally.alo']
p_orange_trail	Missing	['w_mc80mmissile.alo']
p_pedistal_transition00	Missing	['w_pedistal_faction.alo', 'w_pedistal_faction_1.alo', 'w_pedistal_faction_10.alo', 'w_pedistal_faction_2.alo', 'w_pedistal_faction_3.alo', 'w_pedistal_faction_4.alo', 'w_pedistal_faction_5.alo']
p_pedistal_transition01	Missing	['w_pedistal_faction.alo', 'w_pedistal_faction_1.alo', 'w_pedistal_faction_10.alo', 'w_pedistal_faction_2.alo', 'w_pedistal_faction_3.alo', 'w_pedistal_faction_4.alo', 'w_pedistal_faction_5.alo']
p_pedistal_transition02	Missing	['w_pedistal_faction.alo', 'w_pedistal_faction_1.alo', 'w_pedistal_faction_10.alo', 'w_pedistal_faction_2.alo', 'w_pedistal_faction_3.alo', 'w_pedistal_faction_4.alo', 'w_pedistal_faction_5.alo']
p_planet_atmosphere_blue	Missing	['w_planet_alderaan.alo', 'w_planet_datomir.alo', 'w_planet_desert.alo', 'w_planet_endor.alo', 'w_planet_eriadu.alo', 'w_planet_forest.alo', 'w_planet_geonosis.alo', 'w_planet_ice.alo', 'w_planet_kamino.alo', 'w_planet_kuat.alo', 'w_planet_mustafar1.alo', 'w_planet_mustafar2.alo', 'w_planet_ocean.alo', 'w_planet_prop_aargau.alo', 'w_planet_prop_achto.alo', 'w_planet_prop_alderaan.alo', 'w_planet_prop_anaxes.alo', 'w_planet_prop_anoat.alo', 'w_planet_prop_belkadan.alo', 'w_planet_prop_byss.alo', 'w_planet_prop_crait.alo', 'w_planet_prop_dagobah.alo', 'w_planet_prop_dathomir.alo', 'w_planet_prop_desert.alo', 'w_planet_prop_desert01.alo', 'w_planet_prop_desert02.alo', 'w_planet_prop_desert03.alo', 'w_planet_prop_desert04.alo', 'w_planet_prop_dqar.alo', 'w_planet_prop_eadu.alo', 'w_planet_prop_endor.alo', 'w_planet_prop_eriadu.alo', 'w_planet_prop_eriadu01.alo', 'w_planet_prop_exogol.alo', 'w_planet_prop_felucia.alo', 'w_planet_prop_florrum.alo', 'w_planet_prop_forest.alo', 'w_planet_prop_forest01.alo', 'w_planet_prop_forest02.alo', 'w_planet_prop_forest03.alo', 'w_planet_prop_forest04.alo', 'w_planet_prop_geonosis.alo', 'w_planet_prop_geonosis_rings.alo', 'w_planet_prop_ice.alo', 'w_planet_prop_ice01.alo', 'w_planet_prop_ice02.alo', 'w_planet_prop_ice03.alo', 'w_planet_prop_ilum.alo', 'w_planet_prop_jakku.alo', 'w_planet_prop_jedha.alo', 'w_planet_prop_kamino.alo', 'w_planet_prop_kessel.alo', 'w_planet_prop_kuat.alo', 'w_planet_prop_lahmu.alo', 'w_planet_prop_lehon.alo', 'w_planet_prop_mandalore.alo', 'w_planet_prop_moon.alo', 'w_planet_prop_mustafar.alo', 'w_planet_prop_mustafar_blue.alo', 'w_planet_prop_mygeeto.alo', 'w_planet_prop_najedha.alo', 'w_planet_prop_nallhutta.alo', 'w_planet_prop_ocean.alo', 'w_planet_prop_ocean01.alo', 'w_planet_prop_ocean02.alo', 'w_planet_prop_ocean03.alo', 'w_planet_prop_ralltiir.alo', 'w_planet_prop_rattatak.alo', 'w_planet_prop_raxus.alo', 'w_planet_prop_ringovinda.alo', 'w_planet_prop_saleucami.alo', 'w_planet_prop_savareen.alo', 'w_planet_prop_scarif.alo', 'w_planet_prop_serenno.alo', 'w_planet_prop_starkillerbase.alo', 'w_planet_prop_sullust.alo', 'w_planet_prop_swamp.alo', 'w_planet_prop_swamp01.alo', 'w_planet_prop_swamp02.alo', 'w_planet_prop_swamp03.alo', 'w_planet_prop_taris.alo', 'w_planet_prop_taris01.alo', 'w_planet_prop_taspir.alo', 'w_planet_prop_tatooine.alo', 'w_planet_prop_telos.alo', 'w_planet_prop_temperate.alo', 'w_planet_prop_temperate01.alo', 'w_planet_prop_temperate02.alo', 'w_planet_prop_temperate03.alo', 'w_planet_prop_temperate04.alo', 'w_planet_prop_teth.alo', 'w_planet_prop_umbara.alo', 'w_planet_prop_utapau.alo', 'w_planet_prop_vulcanic.alo', 'w_planet_prop_vulpter.alo', 'w_planet_prop_wayland.alo', 'w_planet_prop_zakuul.alo', 'w_planet_prop_zygerria.alo', 'w_planet_ringo.alo', 'w_planet_saleucami.alo', 'w_planet_swamp.alo', 'w_planet_taris1.alo', 'w_planet_taris2.alo', 'w_planet_tatooine.alo', 'w_planet_temperate.alo', 'w_planet_vardos.alo', 'w_planet_vulcanic1.alo', 'w_planet_vulcanic2.alo', 'w_planet_wayland.alo']
p_planet_atmosphere_yellow	Missing	['w_planet_bespin.alo', 'w_planet_gas.alo', 'w_planet_gas_green.alo', 'w_planet_prop_bespin.alo', 'w_planet_prop_gas.alo', 'w_planet_prop_gas_green.alo']
p_planet_deathstar_laser_large	Missing	['w_planet_deathstar.alo']
p_planet_atmosphere_silver	Missing	['w_planet_gas_blue.alo', 'w_planet_gas_silver.alo', 'w_planet_prop_gas_blue.alo', 'w_planet_prop_gas_silver.alo']
p_planet_atmosphere_red	Missing	['w_planet_gas_red.alo', 'w_planet_prop_gas_red.alo', 'w_planet_prop_yavin4.alo', 'w_planet_yavin.alo', 'w_planet_yavin_iv.alo']
p_sulfur	Missing	['w_planet_lolasayu.alo']
p_proton_torpedo00	Missing	['w_protontorp.alo']
p_proton_torpedo	Missing	['w_proton_torpedo.alo']
p_totie95_trail	Missing	['w_proton_torpedo.alo']
p_redlaserflash	Missing	['w_redlaser_largehvyx.alo']
p_stars_med	Missing	['w_stars_low_maw.alo', 'w_stars_maw_solo.alo', 'w_stars_maw_solo_sec.alo']
lensflare0	Missing	['w_stars_low_maw.alo']
